fieldname	standard	vetted	namespace	source	comment
ACCEPTEDNAMEUSAGE	acceptedNameUsage	1	dwc		
ACCEPTEDNAMEUSAGEID	acceptedNameUsageID	1	dwc		
ACCESSRIGHTS	accessRights	1	dcterms		
ANO	year	1	dwc		
AÑO	year	1	dwc		
ASSOCIATEDMEDIA	associatedMedia	1	dwc		
ASSOCIATEDOCCURRENCES	associatedOccurrences	1	dwc		
ASSOCIATEDORGANISMS	associatedOrganisms	1	dwc		
ASSOCIATEDREFERENCES	associatedReferences	1	dwc		
ASSOCIATEDSEQUENCES	associatedSequences	1	dwc		
ASSOCIATEDTAXA	associatedTaxa	1	dwc		
BASISOFIDENTIFICATION		1		FIMS	
BASISOFRECORD	basisOfRecord	1	dwc		
BCID		1		FIMS	
BED	bed	1	dwc		
BEHAVIOR	behavior	1	dwc		
BIBLIOGRAPHICCITATION	bibliographicCitation	1	dcterms		
CATALOGNUMBER	catalogNumber	1	dwc		
CATNUM	catalogNumber	1	dwc		
CLASE	class	1	dwc		
CLASS	class	1	dwc		
COLECTOR	recordedBy	1	dwc		
COLLECTIONCODE	collectionCode	1	dwc		
COLLECTIONID	collectionID	1	dwc		
COLLECTOR	recordedBy	1	dwc		
CONTINENT	continent	1	dwc		
CONTINENT/OCEAN		1			Maps to continent for continents and waterBody for oceans.
CONTINENTE	continent	1	dwc		
COORDENADAS	verbatimCoordinates	1	dwc		
COORDINATEPRECISION	coordinatePrecision	1	dwc		
COORDINATES	verbatimCoordinates	1	dwc		
COORDINATEUNCERTAINTYINMETERS	coordinateUncertaintyInMeters	1	dwc		
COUNTRY	country	1	dwc		
COUNTRYCODE	countryCode	1	dwc		
COUNTY	county	1	dwc		
CUENCA	waterBody	1	dwc		
DATAGENERALIZATIONS	dataGeneralizations	1	dwc		
DATASETID	datasetID	1	dwc		
DATASETNAME	datasetName	1	dwc		
DATE		1			Could be one of many fields.
DATEIDENTIFIED	dateIdentified	1	dwc		
DATUM	geodeticDatum	1	dwc		
DAY	day	1	dwc		
DAYCOLLECTED	day	1	dwc		
DAYIDENTIFIED	dayIdentified	1	dwcloud		Contributes to dwc:dateIdentified
DCTERMS:ACCESSRIGHTS	accessRights	1	dcterms		
DCTERMS:BIBLIOGRAPHICCITATION	bibliographicCitation	1	dcterms		
DCTERMS:LANGUAGE	language	1	dcterms		
DCTERMS:LICENSE	license	1	dcterms		
DCTERMS:MODIFIED	modified	1	dcterms		
DCTERMS:REFERENCES	references	1	dcterms		
DCTERMS:RIGHTSHOLDER	rightsHolder	1	dcterms		
DCTERMS:TYPE	type	1	dcterms		
DECIMALLATITUDE	decimalLatitude	1	dwc		
DECIMALLONGITUDE	decimalLongitude	1	dwc		
DEGREEOFESTABLISHMENT	degreeOfEstablishment	1	dwc		
DETERMINED BY	identifiedBy	1	dwc		
DIA	day	1	dwc		
DÍA	day	1	dwc		
DISPOSITION	disposition	1	dwc		
DRAINAGE	waterBody	1	dwc		
DWC:ACCEPTEDNAMEUSAGE	acceptedNameUsage	1	dwc		
DWC:ACCEPTEDNAMEUSAGEID	acceptedNameUsageID	1	dwc		
DWC:ASSOCIATEDMEDIA	associatedMedia	1	dwc		
DWC:ASSOCIATEDOCCURRENCES	associatedOccurrences	1	dwc		
DWC:ASSOCIATEDORGANISMS	associatedOrganisms	1	dwc		
DWC:ASSOCIATEDREFERENCES	associatedReferences	1	dwc		
DWC:ASSOCIATEDSEQUENCES	associatedSequences	1	dwc		
DWC:ASSOCIATEDTAXA	associatedTaxa	1	dwc		
DWC:BASISOFRECORD	basisOfRecord	1	dwc		
DWC:BED	bed	1	dwc		
DWC:BEHAVIOR	behavior	1	dwc		
DWC:CATALOGNUMBER	catalogNumber	1	dwc		
DWC:CLASS	class	1	dwc		
DWC:COLLECTIONCODE	collectionCode	1	dwc		
DWC:COLLECTIONID	collectionID	1	dwc		
DWC:CONTINENT	continent	1	dwc		
DWC:COORDINATEPRECISION	coordinatePrecision	1	dwc		
DWC:COORDINATEUNCERTAINTYINMETERS	coordinateUncertaintyInMeters	1	dwc		
DWC:COUNTRY	country	1	dwc		
DWC:COUNTRYCODE	countryCode	1	dwc		
DWC:COUNTY	county	1	dwc		
DWC:DATAGENERALIZATIONS	dataGeneralizations	1	dwc		
DWC:DATASETID	datasetID	1	dwc		
DWC:DATASETNAME	datasetName	1	dwc		
DWC:DATEIDENTIFIED	dateIdentified	1	dwc		
DWC:DAY	day	1	dwc		
DWC:DECIMALLATITUDE	decimalLatitude	1	dwc		
DWC:DECIMALLONGITUDE	decimalLongitude	1	dwc		
DWC:DEGREEOFESTABLISHMENT	degreeOfEstablishment	1	dwc		
DWC:DISPOSITION	disposition	1	dwc		
DWC:DYNAMICPROPERTIES	dynamicProperties	1	dwc		
DWC:EARLIESTAGEORLOWESTSTAGE	earliestAgeOrLowestStage	1	dwc		
DWC:EARLIESTEONORLOWESTEONOTHEM	earliestEonOrLowestEonothem	1	dwc		
DWC:EARLIESTEPOCHORLOWESTSERIES	earliestEpochOrLowestSeries	1	dwc		
DWC:EARLIESTERAORLOWESTERATHEM	earliestEraOrLowestErathem	1	dwc		
DWC:EARLIESTPERIODORLOWESTSYSTEM	earliestPeriodOrLowestSystem	1	dwc		
DWC:ENDDAYOFYEAR	endDayOfYear	1	dwc		
DWC:ESTABLISHMENTMEANS	establishmentMeans	1	dwc		
DWC:EVENTDATE	eventDate	1	dwc		
DWC:EVENTID	eventID	1	dwc		
DWC:EVENTREMARKS	eventRemarks	1	dwc		
DWC:EVENTTIME	eventTime	1	dwc		
DWC:FAMILY	family	1	dwc		
DWC:FIELDNOTES	fieldNotes	1	dwc		
DWC:FIELDNUMBER	fieldNumber	1	dwc		
DWC:FOOTPRINTSPATIALFIT	footprintSpatialFit	1	dwc		
DWC:FOOTPRINTSRS	footprintSRS	1	dwc		
DWC:FOOTPRINTWKT	footprintWKT	1	dwc		
DWC:FORMATION	formation	1	dwc		
DWC:GENUS	genus	1	dwc		
DWC:GEODETICDATUM	geodeticDatum	1	dwc		
DWC:GEOLOGICALCONTEXTID	geologicalContextID	1	dwc		
DWC:GEOREFERENCEDBY	georeferencedBy	1	dwc		
DWC:GEOREFERENCEDDATE	georeferencedDate	1	dwc		
DWC:GEOREFERENCEPROTOCOL	georeferenceProtocol	1	dwc		
DWC:GEOREFERENCEREMARKS	georeferenceRemarks	1	dwc		
DWC:GEOREFERENCESOURCES	georeferenceSources	1	dwc		
DWC:GEOREFERENCEVERIFICATIONSTATUS	georeferenceVerificationStatus	1	dwc		
DWC:GROUP	group	1	dwc		
DWC:HABITAT	habitat	1	dwc		
DWC:HIGHERCLASSIFICATION	higherClassification	1	dwc		
DWC:HIGHERGEOGRAPHY	higherGeography	1	dwc		
DWC:HIGHERGEOGRAPHYID	higherGeographyID	1	dwc		
DWC:HIGHESTBIOSTRATIGRAPHICZONE	highestBiostratigraphicZone	1	dwc		
DWC:IDENTIFICATIONID	identificationID	1	dwc		
DWC:IDENTIFICATIONQUALIFIER	identificationQualifier	1	dwc		
DWC:IDENTIFICATIONREFERENCES	identificationReferences	1	dwc		
DWC:IDENTIFICATIONREMARKS	identificationRemarks	1	dwc		
DWC:IDENTIFICATIONVERIFICATIONSTATUS	identificationVerificationStatus	1	dwc		
DWC:IDENTIFIEDBY	identifiedBy	1	dwc		
DWC:INDIVIDUALCOUNT	individualCount	1	dwc		
DWC:INFORMATIONWITHHELD	informationWithheld	1	dwc		
DWC:INFRASPECIFICEPITHET	infraspecificEpithet	1	dwc		
DWC:INSTITUTIONCODE	institutionCode	1	dwc		
DWC:INSTITUTIONID	institutionID	1	dwc		
DWC:ISLAND	island	1	dwc		
DWC:ISLANDGROUP	islandGroup	1	dwc		
DWC:KINGDOM	kingdom	1	dwc		
DWC:LATESTAGEORHIGHESTSTAGE	latestAgeOrHighestStage	1	dwc		
DWC:LATESTEONORHIGHESTEONOTHEM	latestEonOrHighestEonothem	1	dwc		
DWC:LATESTEPOCHORHIGHESTSERIES	latestEpochOrHighestSeries	1	dwc		
DWC:LATESTERAORHIGHESTERATHEM	latestEraOrHighestErathem	1	dwc		
DWC:LATESTPERIODORHIGHESTSYSTEM	latestPeriodOrHighestSystem	1	dwc		
DWC:LIFESTAGE	lifeStage	1	dwc		
DWC:LITHOSTRATIGRAPHICTERMS	lithostratigraphicTerms	1	dwc		
DWC:LOCALITY	locality	1	dwc		
DWC:LOCATIONACCORDINGTO	locationAccordingTo	1	dwc		
DWC:LOCATIONID	locationID	1	dwc		
DWC:LOCATIONREMARKS	locationRemarks	1	dwc		
DWC:LOWESTBIOSTRATIGRAPHICZONE	lowestBiostratigraphicZone	1	dwc		
DWC:MATERIALSAMPLEID	materialSampleID	1	dwc		
DWC:MAXIMUMDEPTHINMETERS	maximumDepthInMeters	1	dwc		
DWC:MAXIMUMDISTANCEABOVESURFACEINMETERS	maximumDistanceAboveSurfaceInMeters	1	dwc		
DWC:MAXIMUMELEVATIONINMETERS	maximumElevationInMeters	1	dwc		
DWC:MEMBER	member	1	dwc		
DWC:MINIMUMDEPTHINMETERS	minimumDepthInMeters	1	dwc		
DWC:MINIMUMDISTANCEABOVESURFACEINMETERS	minimumDistanceAboveSurfaceInMeters	1	dwc		
DWC:MINIMUMELEVATIONINMETERS	minimumElevationInMeters	1	dwc		
DWC:MONTH	month	1	dwc		
DWC:MUNICIPALITY	municipality	1	dwc		
DWC:NAMEACCORDINGTO	nameAccordingTo	1	dwc		
DWC:NAMEACCORDINGTOID	nameAccordingToID	1	dwc		
DWC:NAMEPUBLISHEDIN	namePublishedIn	1	dwc		
DWC:NAMEPUBLISHEDINID	namePublishedInID	1	dwc		
DWC:NAMEPUBLISHEDINYEAR	namePublishedInYear	1	dwc		
DWC:NOMENCLATURALCODE	nomenclaturalCode	1	dwc		
DWC:NOMENCLATURALSTATUS	nomenclaturalStatus	1	dwc		
DWC:OCCURRENCEID	occurrenceID	1	dwc		
DWC:OCCURRENCEREMARKS	occurrenceRemarks	1	dwc		
DWC:OCCURRENCESTATUS	occurrenceStatus	1	dwc		
DWC:ORDER	order	1	dwc		
DWC:ORGANISMID	organismID	1	dwc		
DWC:ORGANISMNAME	organismName	1	dwc		
DWC:ORGANISMQUANTITY	organismQuantity	1	dwc		
DWC:ORGANISMQUANTITYTYPE	organismQuantityType	1	dwc		
DWC:ORGANISMREMARKS	organismRemarks	1	dwc		
DWC:ORGANISMSCOPE	organismScope	1	dwc		
DWC:ORIGINALNAMEUSAGE	originalNameUsage	1	dwc		
DWC:ORIGINALNAMEUSAGEID	originalNameUsageID	1	dwc		
DWC:OTHERCATALOGNUMBERS	otherCatalogNumbers	1	dwc		
DWC:OWNERINSTITUTIONCODE	ownerInstitutionCode	1	dwc		
DWC:PARENTEVENTID	parentEventID	1	dwc		
DWC:PARENTNAMEUSAGE	parentNameUsage	1	dwc		
DWC:PARENTNAMEUSAGEID	parentNameUsageID	1	dwc		
DWC:PATHWAY	pathway	1	dwc		
DWC:PHYLUM	phylum	1	dwc		
DWC:POINTRADIUSSPATIALFIT	pointRadiusSpatialFit	1	dwc		
DWC:PREPARATIONS	preparations	1	dwc		
DWC:PREVIOUSIDENTIFICATIONS	previousIdentifications	1	dwc		
DWC:RECORDEDBY	recordedBy	1	dwc		
DWC:RECORDNUMBER	recordNumber	1	dwc		
DWC:REPRODUCTIVECONDITION	reproductiveCondition	1	dwc		
DWC:SAMPLESIZEUNIT	sampleSizeUnit	1	dwc		
DWC:SAMPLESIZEVALUE	sampleSizeValue	1	dwc		
DWC:SAMPLINGEFFORT	samplingEffort	1	dwc		
DWC:SAMPLINGPROTOCOL	samplingProtocol	1	dwc		
DWC:SCIENTIFICNAME	scientificName	1	dwc		
DWC:SCIENTIFICNAMEAUTHORSHIP	scientificNameAuthorship	1	dwc		
DWC:SCIENTIFICNAMEID	scientificNameID	1	dwc		
DWC:SEX	sex	1	dwc		
DWC:SPECIFICEPITHET	specificEpithet	1	dwc		
DWC:STARTDAYOFYEAR	startDayOfYear	1	dwc		
DWC:STATEPROVINCE	stateProvince	1	dwc		
DWC:SUBGENUS	subgenus	1	dwc		
DWC:TAXONCONCEPTID	taxonConceptID	1	dwc		
DWC:TAXONID	taxonID	1	dwc		
DWC:TAXONOMICSTATUS	taxonomicStatus	1	dwc		
DWC:TAXONRANK	taxonRank	1	dwc		
DWC:TAXONREMARKS	taxonRemarks	1	dwc		
DWC:TYPESTATUS	typeStatus	1	dwc		
DWC:VERBATIMCOORDINATES	verbatimCoordinates	1	dwc		
DWC:VERBATIMCOORDINATESYSTEM	verbatimCoordinateSystem	1	dwc		
DWC:VERBATIMDEPTH	verbatimDepth	1	dwc		
DWC:VERBATIMELEVATION	verbatimElevation	1	dwc		
DWC:VERBATIMEVENTDATE	verbatimEventDate	1	dwc		
DWC:VERBATIMLATITUDE	verbatimLatitude	1	dwc		
DWC:VERBATIMLOCALITY	verbatimLocality	1	dwc		
DWC:VERBATIMLONGITUDE	verbatimLongitude	1	dwc		
DWC:VERBATIMSRS	verbatimSRS	1	dwc		
DWC:VERBATIMTAXONRANK	verbatimTaxonRank	1	dwc		
DWC:VERNACULARNAME	vernacularName	1	dwc		
DWC:WATERBODY	waterBody	1	dwc		
DWC:YEAR	year	1	dwc		
DYNAMICPROPERTIES	dynamicProperties	1	dwc		
EARLIESTAGEORLOWESTSTAGE	earliestAgeOrLowestStage	1	dwc		
EARLIESTEONORLOWESTEONOTHEM	earliestEonOrLowestEonothem	1	dwc		
EARLIESTEPOCHORLOWESTSERIES	earliestEpochOrLowestSeries	1	dwc		
EARLIESTERAORLOWESTERATHEM	earliestEraOrLowestErathem	1	dwc		
EARLIESTPERIODORLOWESTSYSTEM	earliestPeriodOrLowestSystem	1	dwc		
ENDDAYOFYEAR	endDayOfYear	1	dwc		
ESPECIE	specificEpithet	1	dwc		
ESTABLISHMENTMEANS	establishmentMeans	1	dwc		
ESTADO	stateProvince	1	dwc		
EVENTDATE	eventDate	1	dwc		
EVENTID	eventID	1	dwc		
EVENTREMARKS	eventRemarks	1	dwc		
EVENTTIME	eventTime	1	dwc		
EXTRACTIONID		1		FIMS	
FAMILIA	family	1	dwc		
FAMILY	family	1	dwc		
FECHA DE COLECTA	eventDate	1	dwc		
FIELD #		1			Could be a recordNumber or a fieldNumber.
FIELDNOTES	fieldNotes	1	dwc		
FIELDNUMBER	fieldNumber	1	dwc		
FILO	phylum	1	dwc		
FOOTPRINTSPATIALFIT	footprintSpatialFit	1	dwc		
FOOTPRINTSRS	footprintSRS	1	dwc		
FOOTPRINTWKT	footprintWKT	1	dwc		
FORMATION	formation	1	dwc		
FUNDINGSOURCE		1		FIMS	
GENERO	genus	1	dwc		
GÉNERO	genus	1	dwc		
GENETICTISSUETYPE		1		FIMS	"Contributes ""tissue"" to dwc:preparations if present"
GENUS	genus	1	dwc		
GEODETICDATUM	geodeticDatum	1	dwc		
GEOLOGICALCONTEXTID	geologicalContextID	1	dwc		
GEOREFERENCEDBY	georeferencedBy	1	dwc		
GEOREFERENCEDDATE	georeferencedDate	1	dwc		
GEOREFERENCEPROTOCOL	georeferenceProtocol	1	dwc		
GEOREFERENCEREMARKS	georeferenceRemarks	1	dwc		
GEOREFERENCESOURCES	georeferenceSources	1	dwc		
GEOREFERENCEVERIFICATIONSTATUS	georeferenceVerificationStatus	1	dwc		
GROUP	group	1	dwc		
HABITAT	habitat	1	dwc		
HIGHERCLASSIFICATION	higherClassification	1	dwc		
HIGHERGEOGRAPHY	higherGeography	1	dwc		
HIGHERGEOGRAPHYID	higherGeographyID	1	dwc		
HIGHESTBIOSTRATIGRAPHICZONE	highestBiostratigraphicZone	1	dwc		
ID		1			ambiguous
IDENTIFICATIONID	identificationID	1	dwc		
IDENTIFICATIONQUALIFIER	identificationQualifier	1	dwc		
IDENTIFICATIONREFERENCES	identificationReferences	1	dwc		
IDENTIFICATIONREMARKS	identificationRemarks	1	dwc		
IDENTIFICATIONVERIFICATIONSTATUS	identificationVerificationStatus	1	dwc		
IDENTIFIEDBY	identifiedBy	1	dwc		
INDIVIDUALCOUNT	individualCount	1	dwc		
INFORMATIONWITHHELD	informationWithheld	1	dwc		
INFRASPECIFICEPITHET	infraspecificEpithet	1	dwc		
INSTITUTIONCODE	institutionCode	1	dwc		
INSTITUTIONID	institutionID	1	dwc		
ISLA	island	1	dwc		
ISLAND	island	1	dwc		
ISLANDGROUP	islandGroup	1	dwc		
KINGDOM	kingdom	1	dwc		
LANGUAGE	language	1	dcterms		
LAT	verbatimLatitude	1	dwc		If dwc:verbatimLatitude not populated
LATESTAGEORHIGHESTSTAGE	latestAgeOrHighestStage	1	dwc		
LATESTEONORHIGHESTEONOTHEM	latestEonOrHighestEonothem	1	dwc		
LATESTEPOCHORHIGHESTSERIES	latestEpochOrHighestSeries	1	dwc		
LATESTERAORHIGHESTERATHEM	latestEraOrHighestErathem	1	dwc		
LATESTPERIODORHIGHESTSYSTEM	latestPeriodOrHighestSystem	1	dwc		
LATITUD	verbatimLatitude	1	dwc		
LATITUDE	verbatimLatitude	1	dwc		If dwc:verbatimLatitude not populated
LENGTH	length	1	dwcloud		"dynamicProperties as length, or MeasurementOrFact"
LICENSE	license	1	dcterms		
LIFESTAGE	lifeStage	1	dwc		
LITHOSTRATIGRAPHICTERMS	lithostratigraphicTerms	1	dwc		
LOCALIDAD	locality	1	dwc		
LOCALITY	locality	1	dwc		
LOCATIONACCORDINGTO	locationAccordingTo	1	dwc		
LOCATIONID	locationID	1	dwc		
LOCATIONREMARKS	locationRemarks	1	dwc		
LON	verbatimLongitude	1	dwc		If dwc:verbatimLongitude not populated
LONG	verbatimLongitude	1	dwc		If dwc:verbatimLongitude not populated
LONGITUD	verbatimLongitude	1	dwc		
LONGITUDE	verbatimLongitude	1	dwc		If dwc:verbatimLongitude not populated
LOT COUNT	individualCount	1	dwc		
LOWESTBIOSTRATIGRAPHICZONE	lowestBiostratigraphicZone	1	dwc		
MATERIALSAMPLEID	materialSampleID	1	dwc		
MAXIMUMDEPTHINMETERS	maximumDepthInMeters	1	dwc		
MAXIMUMDISTANCEABOVESURFACEINMETERS	maximumDistanceAboveSurfaceInMeters	1	dwc		
MAXIMUMELEVATIONINMETERS	maximumElevationInMeters	1	dwc		
MEMBER	member	1	dwc		
MES	month	1	dwc		
MICROHABITAT		1		FIMS	
MINIMUMDEPTHINMETERS	minimumDepthInMeters	1	dwc		
MINIMUMDISTANCEABOVESURFACEINMETERS	minimumDistanceAboveSurfaceInMeters	1	dwc		
MINIMUMELEVATIONINMETERS	minimumElevationInMeters	1	dwc		
MODIFIED	modified	1	dcterms		
MONTH	month	1	dwc		
MONTHCOLLECTED	month	1	dwc		
MONTHIDENTIFIED	monthIdentified	1	dwcloud		Contributes to dwc:dateIdentified
MUNICIPALITY	municipality	1	dwc		
MUNICIPIO	municipality	1	dwc		
NAMEACCORDINGTO	nameAccordingTo	1	dwc		
NAMEACCORDINGTOID	nameAccordingToID	1	dwc		
NAMEPUBLISHEDIN	namePublishedIn	1	dwc		
NAMEPUBLISHEDINID	namePublishedInID	1	dwc		
NAMEPUBLISHEDINYEAR	namePublishedInYear	1	dwc		
NOMBRE CIENTIFICO	scientificName	1	dwc		
NOMBRE CIENTÍFICO	scientificName	1	dwc		
NOMENCLATURALCODE	nomenclaturalCode	1	dwc		
NOMENCLATURALSTATUS	nomenclaturalStatus	1	dwc		
NUMCAT	catalogNumber	1	dwc		
OCCURRENCEID	occurrenceID	1	dwc		
OCCURRENCEREMARKS	occurrenceRemarks	1	dwc		
OCCURRENCESTATUS	occurrenceStatus	1	dwc		
OCEAN	waterBody	1	dwc		
OCEANO	waterBody	1	dwc		
OCÉANO	waterBody	1	dwc		
ORDEN	order	1	dwc		
ORDER	order	1	dwc		
ORGANISMID	organismID	1	dwc		
ORGANISMNAME	organismName	1	dwc		
ORGANISMQUANTITY	organismQuantity	1	dwc		
ORGANISMQUANTITYTYPE	organismQuantityType	1	dwc		
ORGANISMREMARKS	organismRemarks	1	dwc		
ORGANISMSCOPE	organismScope	1	dwc		
ORIGINALNAMEUSAGE	originalNameUsage	1	dwc		
ORIGINALNAMEUSAGEID	originalNameUsageID	1	dwc		
OTHERCATALOGNUMBERS	otherCatalogNumbers	1	dwc		
OWNERINSTITUTIONCODE	ownerInstitutionCode	1	dwc		
PAÍS	country	1	dwc		
PARENTEVENTID	parentEventID	1	dwc		
PARENTNAMEUSAGE	parentNameUsage	1	dwc		
PARENTNAMEUSAGEID	parentNameUsageID	1	dwc		
PATHWAY	pathway	1	dwc		
PERMITINFORMATION		1		FIMS	
PHOTO	associatedMedia	1	dwc		There could be other fields that also map into associatedMedia.
PHYLUM	phylum	1	dwc		
PLATEID		1		FIMS	
POINTRADIUSSPATIALFIT	pointRadiusSpatialFit	1	dwc		
PREPARATIONS	preparations	1	dwc		
PREPARATOR		1			This may be in addition to a collector.
PRESERVATIVE		1		FIMS	Contributes to dwc:preparations
PREVIOUSIDENTIFICATIONS	previousIdentifications	1	dwc		
PREVIOUSTISSUEID	otherCatalogNumbers	1	dwc	FIMS	"Contributes ""tissue"" to dwc:preparations if present"
PRINCIPALINVESTIGATOR		1		FIMS	
PROVINCE	stateProvince	1	dwc		
PROVINCIA	stateProvince	1	dwc		
RECORDEDBY	recordedBy	1	dwc		
RECORDNUMBER	recordNumber	1	dwc		
REFERENCES	references	1	dcterms		
REINO	kingdom	1	dwc		
REPRODUCTIVECONDITION	reproductiveCondition	1	dwc		
RIGHTSHOLDER	rightsHolder	1	dcterms		
RIO	waterBody	1	dwc		
RÍO	waterBody	1	dwc		
RIVER	waterBody	1	dwc		
SAMPLESIZEUNIT	sampleSizeUnit	1	dwc		
SAMPLESIZEVALUE	sampleSizeValue	1	dwc		
SAMPLINGEFFORT	samplingEffort	1	dwc		
SAMPLINGPROTOCOL	samplingProtocol	1	dwc		
SCIENTIFICNAME	scientificName	1	dwc		
SCIENTIFICNAMEAUTHORSHIP	scientificNameAuthorship	1	dwc		
SCIENTIFICNAMEID	scientificNameID	1	dwc		
SEX	sex	1	dwc		
SEXO	sex	1	dwc		
SPECIES	specificEpithet	1	dwc		
SPECIFICEPITHET	specificEpithet	1	dwc		
STARTDAYOFYEAR	startDayOfYear	1	dwc		
STATE	stateProvince	1	dwc		
STATE/PROVINCE	stateProvince	1	dwc		
STATEPROVINCE	stateProvince	1	dwc		
SUBESPECIE	infraspecificEpithet	1	dwc		
SUBFAMILY		1			Can be mapped into dwc:higherClassification with other fields.
SUBGENUS	subgenus	1	dwc		
SUBSPECIES	infraspecificEpithet	1	dwc		
SUBSTRATUM		1		FIMS	
TAXONCONCEPTID	taxonConceptID	1	dwc		
TAXONID	taxonID	1	dwc		
TAXONOMICSTATUS	taxonomicStatus	1	dwc		
TAXONRANK	taxonRank	1	dwc		
TAXONREMARKS	taxonRemarks	1	dwc		
TISSUESTORAGEID		1		FIMS	
TYPE	type	1	dcterms		
TYPESTATUS	typeStatus	1	dwc		
V_ACCEPTEDNAMEUSAGE	acceptedNameUsage	1	dwc	GBIF	
V_ACCEPTEDNAMEUSAGEID	acceptedNameUsageID	1	dwc	GBIF	
V_ASSOCIATEDMEDIA	associatedMedia	1	dwc	GBIF	
V_ASSOCIATEDOCCURRENCES	associatedOccurrences	1	dwc	GBIF	
V_ASSOCIATEDORGANISMS	associatedOrganisms	1	dwc	GBIF	
V_ASSOCIATEDREFERENCES	associatedReferences	1	dwc	GBIF	
V_ASSOCIATEDSEQUENCES	associatedSequences	1	dwc	GBIF	
V_ASSOCIATEDTAXA	associatedTaxa	1	dwc	GBIF	
V_BASISOFRECORD	basisOfRecord	1	dwc	GBIF	
V_BED	bed	1	dwc	GBIF	
V_BEHAVIOR	behavior	1	dwc	GBIF	
V_CATALOGNUMBER	catalogNumber	1	dwc	GBIF	
V_CLASS	class	1	dwc	GBIF	
V_COLLECTIONCODE	collectionCode	1	dwc	GBIF	
V_COLLECTIONID	collectionID	1	dwc	GBIF	
V_CONTINENT	continent	1	dwc	GBIF	
V_COORDINATEPRECISION	coordinatePrecision	1	dwc	GBIF	
V_COORDINATEUNCERTAINTYINMETERS	coordinateUncertaintyInMeters	1	dwc	GBIF	
V_COUNTRY	country	1	dwc	GBIF	
V_COUNTRYCODE	v_countryCode	1	dwc	GBIF	"GBIF snapshots have countrycode and v_countrycode, leave v_countrycode unmapped to avoid duplicate column name"
V_COUNTY	county	1	dwc	GBIF	
V_DATAGENERALIZATIONS	dataGeneralizations	1	dwc	GBIF	
V_DATASETID	datasetID	1	dwc	GBIF	
V_DATASETNAME	datasetName	1	dwc	GBIF	
V_DATEIDENTIFIED	dateIdentified	1	dwc	GBIF	
V_DAY	day	1	dwc	GBIF	
V_DECIMALLATITUDE	decimalLatitude	1	dwc	GBIF	
V_DECIMALLONGITUDE	decimalLongitude	1	dwc	GBIF	
V_DEGREEOFESTABLISHMENT	degreeOfEstablishment	1	dwc	GBIF	
V_DISPOSITION	disposition	1	dwc	GBIF	
V_DYNAMICPROPERTIES	dynamicProperties	1	dwc	GBIF	
V_EARLIESTAGEORLOWESTSTAGE	earliestAgeOrLowestStage	1	dwc	GBIF	
V_EARLIESTEONORLOWESTEONOTHEM	earliestEonOrLowestEonothem	1	dwc	GBIF	
V_EARLIESTEPOCHORLOWESTSERIES	earliestEpochOrLowestSeries	1	dwc	GBIF	
V_EARLIESTERAORLOWESTERATHEM	earliestEraOrLowestErathem	1	dwc	GBIF	
V_EARLIESTPERIODORLOWESTSYSTEM	earliestPeriodOrLowestSystem	1	dwc	GBIF	
V_ENDDAYOFYEAR	endDayOfYear	1	dwc	GBIF	
V_ESTABLISHMENTMEANS	establishmentMeans	1	dwc	GBIF	
V_EVENTDATE	eventDate	1	dwc	GBIF	
V_EVENTID	eventID	1	dwc	GBIF	
V_EVENTREMARKS	eventRemarks	1	dwc	GBIF	
V_EVENTTIME	eventTime	1	dwc	GBIF	
V_FAMILY	family	1	dwc	GBIF	
V_FIELDNOTES	fieldNotes	1	dwc	GBIF	
V_FIELDNUMBER	fieldNumber	1	dwc	GBIF	
V_FOOTPRINTSPATIALFIT	footprintSpatialFit	1	dwc	GBIF	
V_FOOTPRINTSRS	footprintSRS	1	dwc	GBIF	
V_FOOTPRINTWKT	footprintWKT	1	dwc	GBIF	
V_FORMATION	formation	1	dwc	GBIF	
V_GENUS	genus	1	dwc	GBIF	
V_GEODETICDATUM	geodeticDatum	1	dwc	GBIF	
V_GEOLOGICALCONTEXTID	geologicalContextID	1	dwc	GBIF	
V_GEOREFERENCEDBY	georeferencedBy	1	dwc	GBIF	
V_GEOREFERENCEDDATE	georeferencedDate	1	dwc	GBIF	
V_GEOREFERENCEPROTOCOL	georeferenceProtocol	1	dwc	GBIF	
V_GEOREFERENCEREMARKS	georeferenceRemarks	1	dwc	GBIF	
V_GEOREFERENCESOURCES	georeferenceSources	1	dwc	GBIF	
V_GEOREFERENCEVERIFICATIONSTATUS	georeferenceVerificationStatus	1	dwc	GBIF	
V_GROUP	group	1	dwc	GBIF	
V_HABITAT	habitat	1	dwc	GBIF	
V_HIGHERCLASSIFICATION	higherClassification	1	dwc	GBIF	
V_HIGHERGEOGRAPHY	higherGeography	1	dwc	GBIF	
V_HIGHERGEOGRAPHYID	higherGeographyID	1	dwc	GBIF	
V_HIGHESTBIOSTRATIGRAPHICZONE	highestBiostratigraphicZone	1	dwc	GBIF	
V_IDENTIFICATIONID	identificationID	1	dwc	GBIF	
V_IDENTIFICATIONQUALIFIER	identificationQualifier	1	dwc	GBIF	
V_IDENTIFICATIONREFERENCES	identificationReferences	1	dwc	GBIF	
V_IDENTIFICATIONREMARKS	identificationRemarks	1	dwc	GBIF	
V_IDENTIFICATIONVERIFICATIONSTATUS	identificationVerificationStatus	1	dwc	GBIF	
V_IDENTIFIEDBY	identifiedBy	1	dwc	GBIF	
V_INDIVIDUALCOUNT	individualCount	1	dwc	GBIF	
V_INFORMATIONWITHHELD	informationWithheld	1	dwc	GBIF	
V_INFRASPECIFICEPITHET	infraspecificEpithet	1	dwc	GBIF	
V_INSTITUTIONCODE	institutionCode	1	dwc	GBIF	
V_INSTITUTIONID	institutionID	1	dwc	GBIF	
V_ISLAND	island	1	dwc	GBIF	
V_ISLANDGROUP	islandGroup	1	dwc	GBIF	
V_KINGDOM	kingdom	1	dwc	GBIF	
V_LATESTAGEORHIGHESTSTAGE	latestAgeOrHighestStage	1	dwc	GBIF	
V_LATESTEONORHIGHESTEONOTHEM	latestEonOrHighestEonothem	1	dwc	GBIF	
V_LATESTEPOCHORHIGHESTSERIES	latestEpochOrHighestSeries	1	dwc	GBIF	
V_LATESTERAORHIGHESTERATHEM	latestEraOrHighestErathem	1	dwc	GBIF	
V_LATESTPERIODORHIGHESTSYSTEM	latestPeriodOrHighestSystem	1	dwc	GBIF	
V_LIFESTAGE	lifeStage	1	dwc	GBIF	
V_LITHOSTRATIGRAPHICTERMS	lithostratigraphicTerms	1	dwc	GBIF	
V_LOCALITY	locality	1	dwc	GBIF	
V_LOCATIONACCORDINGTO	locationAccordingTo	1	dwc	GBIF	
V_LOCATIONID	locationID	1	dwc	GBIF	
V_LOCATIONREMARKS	locationRemarks	1	dwc	GBIF	
V_LOWESTBIOSTRATIGRAPHICZONE	lowestBiostratigraphicZone	1	dwc	GBIF	
V_MATERIALSAMPLEID	materialSampleID	1	dwc	GBIF	
V_MAXIMUMDEPTHINMETERS	maximumDepthInMeters	1	dwc	GBIF	
V_MAXIMUMDISTANCEABOVESURFACEINMETERS	maximumDistanceAboveSurfaceInMeters	1	dwc	GBIF	
V_MAXIMUMELEVATIONINMETERS	maximumElevationInMeters	1	dwc	GBIF	
V_MEMBER	member	1	dwc	GBIF	
V_MINIMUMDEPTHINMETERS	minimumDepthInMeters	1	dwc	GBIF	
V_MINIMUMDISTANCEABOVESURFACEINMETERS	minimumDistanceAboveSurfaceInMeters	1	dwc	GBIF	
V_MINIMUMELEVATIONINMETERS	minimumElevationInMeters	1	dwc	GBIF	
V_MONTH	month	1	dwc	GBIF	
V_MUNICIPALITY	municipality	1	dwc	GBIF	
V_NAMEACCORDINGTO	nameAccordingTo	1	dwc	GBIF	
V_NAMEACCORDINGTOID	nameAccordingToID	1	dwc	GBIF	
V_NAMEPUBLISHEDIN	namePublishedIn	1	dwc	GBIF	
V_NAMEPUBLISHEDINID	namePublishedInID	1	dwc	GBIF	
V_NAMEPUBLISHEDINYEAR	namePublishedInYear	1	dwc	GBIF	
V_NOMENCLATURALCODE	nomenclaturalCode	1	dwc	GBIF	
V_NOMENCLATURALSTATUS	nomenclaturalStatus	1	dwc	GBIF	
V_OCCURRENCEID	occurrenceID	1	dwc	GBIF	
V_OCCURRENCEREMARKS	occurrenceRemarks	1	dwc	GBIF	
V_OCCURRENCESTATUS	occurrenceStatus	1	dwc	GBIF	
V_ORDER	order	1	dwc	GBIF	
V_ORGANISMID	organismID	1	dwc	GBIF	
V_ORGANISMNAME	organismName	1	dwc	GBIF	
V_ORGANISMQUANTITY	organismQuantity	1	dwc	GBIF	
V_ORGANISMQUANTITYTYPE	organismQuantityType	1	dwc	GBIF	
V_ORGANISMREMARKS	organismRemarks	1	dwc	GBIF	
V_ORGANISMSCOPE	organismScope	1	dwc	GBIF	
V_ORIGINALNAMEUSAGE	originalNameUsage	1	dwc	GBIF	
V_ORIGINALNAMEUSAGEID	originalNameUsageID	1	dwc	GBIF	
V_OTHERCATALOGNUMBERS	otherCatalogNumbers	1	dwc	GBIF	
V_OWNERINSTITUTIONCODE	ownerInstitutionCode	1	dwc	GBIF	
V_PARENTEVENTID	parentEventID	1	dwc	GBIF	
V_PARENTNAMEUSAGE	parentNameUsage	1	dwc	GBIF	
V_PARENTNAMEUSAGEID	parentNameUsageID	1	dwc	GBIF	
V_PATHWAY	pathway	1	dwc	GBIF	
V_PHYLUM	phylum	1	dwc	GBIF	
V_POINTRADIUSSPATIALFIT	pointRadiusSpatialFit	1	dwc	GBIF	
V_PREPARATIONS	preparations	1	dwc	GBIF	
V_PREVIOUSIDENTIFICATIONS	previousIdentifications	1	dwc	GBIF	
V_RECORDEDBY	recordedBy	1	dwc	GBIF	
V_RECORDNUMBER	recordNumber	1	dwc	GBIF	
V_REPRODUCTIVECONDITION	reproductiveCondition	1	dwc	GBIF	
V_SAMPLESIZEUNIT	sampleSizeUnit	1	dwc	GBIF	
V_SAMPLESIZEVALUE	sampleSizeValue	1	dwc	GBIF	
V_SAMPLINGEFFORT	samplingEffort	1	dwc	GBIF	
V_SAMPLINGPROTOCOL	samplingProtocol	1	dwc	GBIF	
V_SCIENTIFICNAME	scientificName	1	dwc	GBIF	
V_SCIENTIFICNAMEAUTHORSHIP	scientificNameAuthorship	1	dwc	GBIF	
V_SCIENTIFICNAMEID	scientificNameID	1	dwc	GBIF	
V_SEX	sex	1	dwc	GBIF	
V_SPECIFICEPITHET	specificEpithet	1	dwc	GBIF	
V_STARTDAYOFYEAR	startDayOfYear	1	dwc	GBIF	
V_STATEPROVINCE	stateProvince	1	dwc	GBIF	
V_SUBGENUS	subgenus	1	dwc	GBIF	
V_TAXONCONCEPTID	taxonConceptID	1	dwc	GBIF	
V_TAXONID	taxonID	1	dwc	GBIF	
V_TAXONOMICSTATUS	taxonomicStatus	1	dwc	GBIF	
V_TAXONRANK	taxonRank	1	dwc	GBIF	
V_TAXONREMARKS	taxonRemarks	1	dwc	GBIF	
V_TYPESTATUS	typeStatus	1	dwc	GBIF	
V_VERBATIMCOORDINATES	verbatimCoordinates	1	dwc	GBIF	
V_VERBATIMCOORDINATESYSTEM	verbatimCoordinateSystem	1	dwc	GBIF	
V_VERBATIMDEPTH	verbatimDepth	1	dwc	GBIF	
V_VERBATIMELEVATION	verbatimElevation	1	dwc	GBIF	
V_VERBATIMEVENTDATE	verbatimEventDate	1	dwc	GBIF	
V_VERBATIMLATITUDE	verbatimLatitude	1	dwc	GBIF	
V_VERBATIMLOCALITY	verbatimLocality	1	dwc	GBIF	
V_VERBATIMLONGITUDE	verbatimLongitude	1	dwc	GBIF	
V_VERBATIMSRS	verbatimSRS	1	dwc	GBIF	
V_VERBATIMTAXONRANK	verbatimTaxonRank	1	dwc	GBIF	
V_VERNACULARNAME	vernacularName	1	dwc	GBIF	
V_WATERBODY	waterBody	1	dwc	GBIF	
V_YEAR	year	1	dwc	GBIF	
VERBATIMCOORDINATES	verbatimCoordinates	1	dwc		
VERBATIMCOORDINATESYSTEM	verbatimCoordinateSystem	1	dwc		
VERBATIMDEPTH	verbatimDepth	1	dwc		
VERBATIMELEVATION	verbatimElevation	1	dwc		
VERBATIMEVENTDATE	verbatimEventDate	1	dwc		
VERBATIMLATITUDE	verbatimLatitude	1	dwc		
VERBATIMLOCALITY	verbatimLocality	1	dwc		
VERBATIMLONGITUDE	verbatimLongitude	1	dwc		
VERBATIMSRS	verbatimSRS	1	dwc		
VERBATIMTAXONRANK	verbatimTaxonRank	1	dwc		
VERNACULARNAME	vernacularName	1	dwc		
WATERBODY	waterBody	1	dwc		
WEIGHT	weight	1	dwcloud		"dynamicProperties as weight, or MeasurementOrFact"
WELLID		1		FIMS	
WORMSID	taxonID	1	dwc	FIMS	
YEAR	year	1	dwc		
YEARCOLLECTED	year	1	dwc		
YEARIDENTIFIED	yearIdentified	1	dwcloud		Contributes to dwc:dateIdentified