identificationqualifier	standard	vetted
 B1001 TYPE OF PACHYCEPHALA RUFIVENTRIS MINOR, ZIETZ, 1914 (SEE SAOA 1(1):15		1
 N. SP.	sp. nov.	1
 SP.	sp.	1
 SYNTYPE OF RHIPIDURA MAYI, ASHBY, 1911 (SEE EMU 11:41)		1
"		1
"SP. 1"	sp.	1
"SP. 2"	sp.	1
(=Z. CORNUTUS)		1
(ACHIROSTOMIAS)  N. SP.	sp. nov.	1
(ALBURNOPS) SP.	sp.	1
(ALBURNOPS) SP. LONGIROSTRIS	sp.	1
(ALVORDIUS) SP.	sp.	1
(AURULENTA SUBSP.)	ssp.	1
(BIRADIOSTOMIAS) SP.	sp.	1
(BUDYTES ?) SP.	sp.	1
(CATONOTUS) SP.	sp.	1
(CYPRINELLA) SP.	sp.	1
(DORATION) SP.	sp.	1
(DUMÉRIL & BIBRON, 1839)		1
(DUMÉRIL & BIBRON, 1841)		1
(DUMÉRIL, 1853)		1
(ETHEOSTOMA) SP.	sp.	1
(GYROLOIDES SUBSP.)	ssp.	1
(HAPCLONUS) SP.	sp.	1
(LORICARIICHTHYS)SP.	sp.	1
(NANOSTOMA) SP.	sp.	1
(NOMINOSTOMIAS ) N. SP.	sp. nov.	1
(NOMINOSTOMIAS) N. SP. A	sp. nov.	1
(NOMINOSTOMIAS) N. SP. B	sp. nov.	1
(NOMINOSTOMIAS) SP.	sp.	1
(NOMINOSTOMIAS) SP. #1	sp.	1
(NOMINOSTOMIAS) SP. (#2)	sp.	1
(PROBABLY)	in question	1
(PTERONOTROPIST) SP.	sp.	1
(S.S.) SP.	sp.	1
(SLHUMOPS) SP. LONGINOSTRIS	sp.	1
(SP. NOV)	sp. nov.	1
(SP.)	sp.	1
(SP.?)	sp.	1
(ULOCENTRA) SP.	sp.	1
*SPECIMEN LOST		1
?	id in question	1
? CLASS	class in question	1
? CLASS ?ID	class in question	1
? FAM	family in question	1
? FAM & GENUS	family, genus in question	1
? FAM ORDER	order, family in question	1
? FAM, ? GEN	family, genus in question	1
? FAMILY	family in question	1
? FM	family in question	1
? GEN	genus in question	1
? GEN & SP.	genus, species in question	1
? GEN ? SP	genus, species in question	1
? GEN ?SP	genus, species in question	1
? GEN.	genus in question	1
? GEN. & SP.	genus, species in question	1
? GEN+FAM	family, genus in question	1
? GEN+SP	genus, species in question	1
? GENUS	genus in question	1
? GN	genus in question	1
? ID	id in question	1
? ORD	order in question	1
? ORDER	order in question	1
? ORDER ? FAM	order, family in question	1
? ORDER ? FAMILY	order, family in question	1
? ORDER ?FAM	order, family in question	1
? ORDER, FAM	order, family in question	1
? ORDER; TENT. GEN&SP.	order in question	1
? ORDR	order in question	1
? ORDR ? FAM	order, family in question	1
? OTHER ID	id in question	1
? OTHERID	id in question	1
? SP	species in question	1
? SP.	species in question	1
? SP.; NOT AVAILABLE TO GPW	species in question	1
? SPECIES	species in question	1
? SUBFAM	subfamily in question	1
? SUBFAMILY	subfamily in question	1
? TAXON	id in question	1
?, ?GENUS	genus in question	1
?, ?GENUS, ?SP	genus, species in question	1
?, ?SP	species in question	1
?, ?SP, WORN	species in question	1
?, ?SP.	species in question	1
?, CF SP	species in question	1
?, WORN	species in question	1
?CL	class in question	1
?CLASS	class in question	1
?ELE	id in question	1
?ELE (DP4/), ?SP	species in question	1
?FAM	family in question	1
?FAM ?GEN	family, genus in question	1
?FAMILY	family in question	1
?FM	family in question	1
?FORMOSA?THOMPS.; (WEIL 2004)	id in question	1
?GE	genus in question	1
?GEN	genus in question	1
?GEN ?SP	genus, species in question	1
?GEN.	genus in question	1
?GEN; L > 4MM (WEIL 2004)	genus in question	1
?GENUS	genus in question	1
?GENUS, ?SP	genus, species in question	1
?GENUS, BIG	genus in question	1
?GN	genus in question	1
?GN ?SP	genus, species in question	1
?GN?SP	genus, species in question	1
?ORD?FM	order, family in question	1
?ORDER	order in question	1
?ORDER ?GEN	genus in question	1
?OTHER ID	id in question	1
?SP	species in question	1
?SP ?TROCHUUS	species in question	1
?SP, ?GENUS	genus, species in question	1
?SP, BIG	species in question	1
?SP, SMALL	species in question	1
?SP, WORN	species in question	1
?SP.	species in question	1
?SP.; NOT AVAILABLE TO GPW	species in question	1
?SP; BIG	species in question	1
?SP; M. SEMINOENSIS OR E. BROWNI	species in question	1
?SP; NOT AVAILABLE TO GPW	species in question	1
?SP; SMALL	species in question	1
?SP; VERY BIG	species in question	1
?SPECIES	species in question	1
?SUBFAM	subfamily in question	1
[N. GEN., N. SP.]	gen. nov.	1
`		1
{BILLSI N. SP.}	sp. nov.	1
{CHILALA N. SP.}	sp. nov.	1
{CONGO N. SP.}	sp. nov.	1
{KALUNGWISHI N. SP.}	sp. nov.	1
{L. KYOGO N. SP.}	sp. nov.	1
{MALAGARASI N. SP.}	sp. nov.	1
{MANGULA N. SP.}	sp. nov.	1
{MOTTLED N. SP. 2.}	sp. nov.	1
{NTUMBACHUSHI N. SP.}	sp. nov.	1
{RUIKI N. SP.}	sp. nov.	1
{RUVU N. SP.}	sp. nov.	1
{RUZIZI N. SP.}	sp. nov.	1
{UBANGI 1 N. SP.}	sp. nov.	1
{ZAKONI N. SP.}	sp. nov.	1
<SP. A>	sp.	1
<SP. B>	sp.	1
<SP. MEDIUM COSTATE>	sp.	1
1(1):15. W.D. DODD NO. 559.		1
14.5 IN. S.L.		1
155 M.M. S.L.		1
180MM S.L., (DRIED)		1
190 M.M. S.L.		1
1967		1
200 M.M. S.L.		1
212 M.M. S.L.		1
215 M.M. S.L.		1
220 M.M. S.L.		1
225 M.M. S.L.		1
234 M.M. S.L.		1
243 M.M. S.L.		1
250 M.M. S.L.		1
255 M.M. S.L.		1
258 M.M. S.L.		1
260 M.M. S.L.		1
262 M.M. S.L.		1
294 M.M. S.L.		1
300 M.M. S.L.		1
310MM S.L.,HEAD=78MM		1
315MM S.L.,HEAD=84MM		1
344 M.M. S.L.		1
370 M.M. S.L.		1
4 SAMA PARATYPES (NUMBERS UNKNOWN) MISSING		1
400 M.M. T.L.		1
435 M.M. S.L.		1
44.5 C.M. T.L.		1
451 M.M. S.L.		1
480 M.M. S.L.		1
490 M.M. T.L.		1
670 M.M. S.L.		1
740M.M.S.L.TIP OF TAIL AB		1
ABDOMEN SP. 1	sp.	1
ABDOMEN SP. 2	sp.	1
ACSMITHIA SP.	sp.	1
AEGYPTIACA X SP.	aegyptiaca X sp.	1
AFF MALDIVENSIS	aff. maldivensis	1
AFF SP	aff.	1
AFF.	aff.	1
AFF.  BOGOTENSIS	aff. bogotensi	1
AFF.  SAVAGEI	aff. savagei	1
AFF. AMETHYSTINA	aff. amethystina	1
AFF. AUREOPIGMENTATUS	aff. aureopigmentatus	1
AFF. BOGOTENSIS	aff. bogotensi	1
AFF. EMETICA	aff. emetica	1
AFF. HUMIDICOLA	aff. humidicola	1
AFF. LACCATA	aff. laccata	1
AFF. LENTIGINOSA	aff. lentiginosa	1
AFF. NERVOSA	aff. nervosa	1
AFF. OBSCURATUS	aff. obscuratus	1
AFF. OLIGOPORPA	aff. oligoporpa	1
AFF. OVATA	aff. ovata	1
AFF. PALMATA	aff. palmata	1
AFF. PANICULATA	aff. paniculata	1
AFF. RIPARIA	aff. riparia	1
AFF. SMILACINUS	aff. smilacinus	1
AFF. SORORCULA	aff. sororcula	1
AFF. SP. 3A	aff.	1
AFF. SP. A	aff.	1
AFF. SP. E	aff.	1
AFF. SP. OLIVER IN OLIVER ET AL. 1975	aff.	1
AFF. UISAE	aff. uisae	1
ALONG WITH B548 & B549 SYNTYPE OF SERICORNIS MACULATUS HOUTMANENSIS, ZIETZ, 1921, (SEE SAOA 6(2): 44-5). W.D. DODD NO. 119.		1
AMERICANA OR CRASSIDENS	species in question	1
ARGYROPLEURON SP. 1	sp.	1
ARGYROPLEURON SP. 2	sp.	1
ARVICOLINAE		1
ASH.SP.A	sp.	1
ASH.SP.B	sp.	1
ASH.SP.C	sp.	1
ASPER  N. GEN,	gen. nov.	1
AURICEPS LARGE BLACK TAILED SP.	sp.	1
B SP.	sp.	1
B1336 HOLOTYPE OF APROSMICTUS ERYTHROPTERUS MELVILLENSIS, ZIETZ, 1914 (SEE SAOA 1(1):14		1
B1365 TYPE SPECIMEN OF CHALCOPHAPS CHRYSOCHLORA MELVILLENSIS, ZIETZ, 1914 (SEE SAOA 1(1):12). W.D. DODD NO. 630.		1
B2237 HOLOTYPE OF PSEPHOTUS HAEMATONOTUS CAERULEUS, CONDON, 1941 (SEE RECORDS SAM 7:141)		1
B2303 TYPE OF CLIMACTERIS WAITEI,WHITE, 1917 (SEE EMU 16:168-9); B2304 PARATYPE OF CLIMACTERIS WAITEI, WHITE, 1917 (SEE EMU 16:168-9)		1
B4506 HOLOTYPE OF ZOSTEROPS WESTERNENSIS FLINDERSENSIS, ASHBY, 1925 (SEE EMU 25:117)		1
B547,  B548 & B549 SYNTYPE OF SERICORNIS MACULATUS HOUTMANENSIS, ZIETZ, 1921, (SEE SAOA 6(2): 44-5). W.D. DODD NO. 119.		1
B547, B548 & B549 SYNTYPE OF SERICORNIS MACULATUS HOUTMANENSIS, ZIETZ, 1921, (SEE SAOA 6(2): 44-5). W.D. DODD NO. 119.		1
B5669 HOLOTYPE OF CALAMANTHUS FULIGINOSUS SUTTONI, CONDON, 1951 (SEE SAOA 20:51)		1
B5673  HOLOTYPE OF CINCLOSOMA CASTANOTUSM MORGANI, CONDON, 1951 (SEE SAOA 20:42)		1
BAILEYI N. SP.	sp. nov.	1
BALANUSSP.	sp.	1
BALSODICHTHYS X SP.	balsodichthys X sp.	1
BELLENDENENSIS N.SP.	sp. nov.	1
BIG		1
BISACCATE SP. 1	sp.	1
BODY SP. 1 CF. ADEMOSYNE	sp.	1
BODY SP. 2	sp.	1
BODY SP. 3	sp.	1
BOTULUM N. SP.	sp. nov.	1
BOYCE 1989 SP. NOV. A.	sp. nov.	1
BROKEN		1
BRYANTI N. SP.	sp. nov.	1
BUFO SP.	sp.	1
C		1
C SP.1	sp.	1
C. SP. X G. NYCTHEMERUS	C. sp. X G. nycthemerus	1
C. SP. X P. COLCHICUS	C. sp. X P. colchicus	1
C.F. CANADENSIS	cf. canadensis	1
C.F. CHAETODIPUS	cf. Chaetodipus	1
C.F. CINEREA	cf. cinerea	1
C.F. MARMOTA FLAVIVENTRIS	cf. Marmota flaviventris	1
C.F. NEOTOMA	cf. Neotoma	1
C.F. OVIS C.F. CANADENSIS	cf. canadensis	1
C.F. SPILOGALE	cf. Spilogale	1
C.F. TIGRIS	cf. tigris	1
CACTORUM SP. NOV.	sp. nov.	1
CANDICHORUM (SP.?)	sp.	1
CF	cf.	1
CF ACHIRUS	cf. achirus	1
CF ACULEATUS	cf. aculeatus	1
CF AEQUIPINNIS	cf. aequipinnis	1
CF AFFINIS	cf. affinis	1
CF ALICIAE	cf. aliciae	1
CF ANTIPODIANUS	cf. antipodianus	1
CF ATRUM	cf. atrum	1
CF BARBATUS	cf. barbatus	1
CF BOLINICHTHYS	cf. Bolinichthys	1
CF BOUGAINVILLII	cf. bougainvillii	1
CF BOULENGERI	cf. boulengeri	1
CF BRACHYGNATHUM	cf. brachygnathum	1
CF CALCEA	cf. calcea	1
CF CHAETODIPUS	cf. Chaetodipus	1
CF CINEREA	cf. cinerea	1
CF CINEREOARGENTEUS	cf. cinereoargenteus	1
CF CLASS	cf.	1
CF CRIBRORIS	cf. cribroris	1
CF DUNCKERI	cf. dunckeri	1
CF EFFULGENS	cf. effulgens	1
CF FAM	cf.	1
CF FAM CF GEN	cf.	1
CF FAMILY	cf.	1
CF FILAMENTOSUS	cf. filamentosus	1
CF FLAVIVENTRIS	cf. flaviventris	1
CF FM	cf.	1
CF GEN	cf.	1
CF GEN + SP	cf.	1
CF GEN CF SP	cf.	1
CF GEN, ?SP	cf.	1
CF GEN+SP	cf.	1
CF GENUS	cf.	1
CF GENUS AND SPECIES	cf.	1
CF GN	cf.	1
CF GN CF SP	cf.	1
CF HELLWALDII	cf. hellwaldii	1
CF INDICUS	cf. indicus	1
CF INTIMA	cf. intima	1
CF LONGIMANUS	cf. longimanus	1
CF LUCIFER	cf. lucifer	1
CF LUETKENI	cf. luetkeni	1
CF MALAYANA	cf. malayana	1
CF MELBOURNENSIS	cf. melbournensis	1
CF MICROCEPHALUS	cf. microcephalus	1
CF NIGRESCENS	cf. nigrescens	1
CF OBLONGUS	cf. oblongus	1
CF OBTUSIROSTRE	cf. obtusirostre	1
CF OCCIDENTALIS	cf. occidentalis	1
CF OLIDUS	cf. olidus	1
CF ORDER	cf.	1
CF OTHER_ID	cf.	1
CF OTHERID	cf.	1
CF OVIS CANADENSIS	cf. Ovis canadensis	1
CF PAUCIMACULATUS	cf. paucimaculatus	1
CF PHILIPPINENSIS	cf. philippinensis	1
CF PONTOHI	cf. pontohi	1
CF QUADRISPINOSA	cf. quadrispinosa	1
CF RHABDOGNATHUS RARUS.	cf. Rhabdognathus rarus	1
CF RHOMBOIDEA	cf. rhomboidea	1
CF SCHEELEI	cf. scheelei	1
CF SP	cf.	1
CF SP CF GN	cf.	1
CF SP, ?GENUS, WORN	cf.	1
CF SP, VERY WORN	cf.	1
CF SP, WORN	cf.	1
CF SP.	cf.	1
CF SP. A	sp.	1
CF SP; ?GENUS	cf.	1
CF SPECIES	cf.	1
CF SPILOGALE	cf. Spilogale	1
CF SPINIFERA	cf. spinifera	1
CF STENODACTYLUM	cf. stenodactylum	1
CF SUBFAM	cf.	1
CF SUBORDER	cf.	1
CF SUBSP	cf.	1
CF SUBSPECIES	cf.	1
CF VAIGIENSIS	cf. vaigiensis	1
CF VIRIDIS	cf. viridis	1
CF, SO,	cf.	1
CF.	cf.	1
CF. A. NOBILIS	cf. A. nobilis	1
CF. ACUMINATA	cf. acuminata	1
CF. AETIOCETIDAE	cf. Aetiocetidae	1
CF. BUROLETTI	cf. buroletti	1
CF. C. OCCIDENTALIS	cf. C. occidentalis	1
CF. CARACASANUM	cf. caracasanum	1
CF. DIPLOSTEMONA	cf. diplostemona	1
CF. FAM.	cf.	1
CF. FAMILY	cf.	1
CF. FAMILY, CF. GENUS	cf.	1
CF. FAMILY, GE. CF.	cf.	1
CF. FAMILY, SUBFAMILY	cf.	1
CF. FRONDOSA	cf. frondosa	1
CF. G. MORINGA	cf. G. moringa	1
CF. GEN	cf.	1
CF. GEN.	cf.	1
CF. GENUS	cf.	1
CF. HYLOPHILUS	cf. hylophilus	1
CF. IRIDOLEPIS	cf. iridolepis	1
CF. LATRANS	cf. latrans	1
CF. MAJOR	cf. major	1
CF. MERIDENSIS	cf. meridensis	1
CF. MORETONENSIS (SP. B)	cf. moretonensis	1
CF. N. SP. F OF KLAPPER	sp.	1
CF. OBSCURIFOLIA	cf. obscurifolia	1
CF. ORDER	cf.	1
CF. OTHER_ID	cf.	1
CF. OTHERID	cf.	1
CF. PULCHRA	cf. pulchra	1
CF. SP	sp.	1
CF. SP, SPP	sp.	1
CF. SP.	sp.	1
CF. SP. 1	sp.	1
CF. SP. 2	sp.	1
CF. SP. 3	sp.	1
CF. SP. A	sp.	1
CF. SP. A GORDON & YOCHELSON 1987	sp.	1
CF. SP. B	sp.	1
CF. SP. G2	sp.	1
CF. SP. II	sp.	1
CF. SP. NOV.	sp.	1
CF. SP., ?SP.	sp.	1
CF. SP.; WORN	sp.	1
CF. SPECIES	sp.	1
CF. SPIRALIS	cf. spiralis	1
CF. SUBFAMILY	cf.	1
CF. UMBRATUS	cf. umbratus	1
CF.GN	cf.	1
CF.GN SP	cf.	1
CF.SP	sp.	1
CFSP	sp.	1
CHIASMOCLEIS SP.	sp.	1
CHRYSOCEPHALA S	sp.	1
CHRYSOCEPHALUS X SP.	chrysocephalus X sp.	1
CL ?	class in question	1
CL ? ;OR ?	class, order question in order	1
CL CF	class in question	1
CL?	class in question	1
CLASS ?	class in question	1
CLASS CF	cf.	1
CLAVUS SP. 1	sp.	1
CLAVUS SP. 2	sp.	1
CLAVUS SP. 3	sp.	1
CLAVUS SP. 4	sp.	1
CLAVUS SP. 5	sp.	1
COLCHICUS MONGOLICUS X COLCHICUS SSP.	colchicus mongolicus X colchicus ssp.	1
COLOBRI AFF. THALASSINUS	aff. thalassinus	1
CRASSUM SP. NOV	sp. nov.	1
CRYPTODIRA		1
CURIOSUS SP. NO	sp. nov.	1
CYANELLUS X L. SP.	cyanellus x L. sp.	1
CYANELLUS X SP.	cyanellus X sp.	1
DARWINI N.SP.	sp. nov.	1
DFH  SP. 18	sp.	1
DFH  SP. 34	sp.	1
DFH  SP. 36	sp.	1
DFH N.SP.	sp.	1
DFH SP. 12	sp.	1
DFH SP. 36	sp.	1
DFH SP.16	sp.	1
DFH SP.17	sp.	1
DFH SP.4	sp.	1
DFH SP.6	sp.	1
DFH SP.8	sp.	1
DFH SP.9	sp.	1
DIV. 1 SP.	sp.	1
DR GLENN SHEA - AUSTRALIAN MUSEUM		1
DR PAUL OLIVER - MUSEUM VICTORIA		1
EGREGIA OR SP. NOV.	sp.	1
ELYTRA SP. 1	sp.	1
ELYTRA SP. 2	sp.	1
ELYTRA SP. 3	sp.	1
ELYTRA SP. 4	sp.	1
ELYTRA SP. 5	sp.	1
ELYTRA SP. 6	sp.	1
ELYTRA SP. 7	sp.	1
EMYDIDC		1
ERINACEOIDEA		1
ERYOPS ALSO		1
EURYODUS ALSO		1
EX. GR.	ex. gr.	1
FA ?	family in question	1
FA ? ;GE ?	family, genus in question	1
FA ? ;GE ? ;SP ?	family, genus, species in question	1
FA ? ;GE CF	family in question	1
FA ? ;OI ?	family in question	1
FA ? ;SP CF	family in question	1
FA CF	cf.	1
FA CF;GE ?	genus in question	1
FAM ?	family in question	1
FAM. ?	family in question	1
FEMALE, 505M.M. S.L.		1
FEMALE?		1
FEWER RIDGES SP.	sp.	1
FL=80M.M.		1
FM ?	family in question	1
FM CF	cf.	1
FM GN ?	family, genus in question	1
FM?	family in question	1
FUSCA N. SP.	sp. nov.	1
G J. WITTEN		1
GALBULA SSP. BULLOCKII	ssp.	1
GARDINERI N.SP.	sp. nov.	1
GE ?	genus in question	1
GE ? ;OI ?	genus in question	1
GE ? ;SP ?	genus, species in question	1
GE ? ;SP CF	genus, species in question	1
GE ? OR DESMOSTYLUS?	genus in question	1
GE CF	cf.	1
GE CF.	cf.	1
GE CF;SP ?	cf.	1
GE CF;SP CF	cf.	1
GE NR	cf.	1
GE. CF.	cf.	1
GE. CF. SP. CF.	cf.	1
GE?	genus in question	1
GEN	genus in question	1
GEN AND SP. INDET. A	gen. indet.	1
GEN AND SP. INDET. B	gen. indet.	1
GEN CF.	cf.	1
GEN IN QUOTES	genus in question	1
GEN INDET	gen. indet.	1
GEN NR	genus in question	1
GEN. ?	genus in question	1
GEN. A SP. A	gen. indet.	1
GEN. A, SP. 1	gen. indet.	1
GEN. A, SP. A	gen. indet.	1
GEN. AND SP. INDET.	gen. indet.	1
GEN. AND SP. INDET. 2	gen. indet.	1
GEN. AND SP. INDET. A	gen. indet.	1
GEN. AND SP. INDET. C	gen. indet.	1
GEN. B, SP. A	gen. indet.	1
GEN. B. SP. 1	gen. indet.	1
GEN. C, SP. A	gen. indet.	1
GEN. D SP. 1	gen. indet.	1
GEN. D SP. 2	gen. indet.	1
GEN. D SP. 3	gen. indet.	1
GEN. D SP. 4	gen. indet.	1
GEN. D, SP. A	gen. indet.	1
GEN. ET SP. 1	gen. indet.	1
GEN. ET SP. 1 NOV.	gen. nov.	1
GEN. ET SP. 2	gen. indet.	1
GEN. ET SP. 3	gen. indet.	1
GEN. ET SP. 3 NOV.	gen. indet.	1
GEN. ET SP. A	gen. indet.	1
GEN. ET SP. B	gen. indet.	1
GEN. ET SP. IND. 2	gen. indet.	1
GEN. ET SP. INDET	gen. indet.	1
GEN. ET SP. INDET A	gen. indet.	1
GEN. ET SP. INDET B	gen. indet.	1
GEN. ET SP. INDET.	gen. indet.	1
GEN. ET SP. INDET. 1	gen. indet.	1
GEN. ET SP. INDET. 2	gen. indet.	1
GEN. ET SP. INDET. 3	gen. indet.	1
GEN. ET SP. INDET. 4	gen. indet.	1
GEN. ET SP. INDET. A	gen. indet.	1
GEN. ET SP. INDET. B	gen. indet.	1
GEN. ET SP. INDET. C	gen. indet.	1
GEN. ET SP. INDET. D	gen. indet.	1
GEN. ET SP. INDET. E	gen. indet.	1
GEN. ET SP. INDET. F	gen. indet.	1
GEN. ET SP. INDET. G	gen. indet.	1
GEN. ET SP. INDET. H	gen. indet.	1
GEN. ET SP. INDET. I	gen. indet.	1
GEN. ET SP. INDET. II	gen. indet.	1
GEN. ET SP. INDET. J	gen. indet.	1
GEN. ET SP. INDET. K	gen. indet.	1
GEN. ET SP. INDET. L	gen. indet.	1
GEN. ET SP. N. A	gen. nov.	1
GEN. ET SP. NOV.	gen. nov.	1
GEN. ET SP. NOV. 1	gen. nov.	1
GEN. ET SP. NOV. 2	gen. nov.	1
GEN. ET SP. NOV. 3	gen. nov.	1
GEN. ET SP. NOV. 5	gen. nov.	1
GEN. ET SP. NOV. 6	gen. nov.	1
GEN. ET SP. NOV. 7	gen. nov.	1
GEN. ET SP. NOV. 8	gen. nov.	1
GEN. ET SP. NOV. 9	gen. nov.	1
GEN. ET SP. NOV. A	gen. nov.	1
GEN. ET SP. NOV. A (LARGE)	gen. nov.	1
GEN. ET SP. NOV. B	gen. nov.	1
GEN. ET SP. NOV. B (SMALL)	gen. nov.	1
GEN. ET SP.IND.4	gen. indet.	1
GEN. ET. SP. 1	gen. indet.	1
GEN. ET. SP. 2	gen. indet.	1
GEN. ET. SP. IND.	gen. indet.	1
GEN. ET. SP. IND. 1	gen. indet.	1
GEN. ET. SP. IND. 2	gen. indet.	1
GEN. ET. SP. IND. 3	gen. indet.	1
GEN. ET. SP. INDET	gen. indet.	1
GEN. ET. SP. INDET.	gen. indet.	1
GEN. INDET. SP. A	gen. indet.	1
GEN. INDET. SP. B	gen. indet.	1
GEN. INDET. SP. C	gen. indet.	1
GEN. INDET. SP. D	gen. indet.	1
GEN. INDET. SP. E	gen. indet.	1
GEN. INDET. SP. F	gen. indet.	1
GEN. INDET. SP. G	gen. indet.	1
GEN. INDET. SP. H	gen. indet.	1
GEN. NOV. & SP. NOV.	gen. nov.	1
GEN. NOV. & SP. NOV. A	gen. nov.	1
GEN. NOV. & SP. NOV. B	gen. nov.	1
GEN. NOV. A, SP. NOV. A A	gen. nov.	1
GEN. NOV. A, SP. NOV. A B	gen. nov.	1
GEN. NOV. SP. LARGE	gen. nov.	1
GEN. NOV. SP. SMALL	gen. nov.	1
GEN?	genus in question	1
GENUS ?	genus in question	1
GENUS 1 SP. A	gen. indet.	1
GENUS 2 SP. A	gen. indet.	1
GENUS AND SPECIES UNCERTAIN, FAMILY IDENTIFIED	gen. indet.	1
GENUS AND SPECIES UNKNOWN, FAMILY IDENTIFIED	gen. indet.	1
GENUS IDENTIFIED, SPECIES UNCERTAIN	species in question	1
GENUS IDENTIFIED, SPECIES UNKNOWN	sp.	1
GENUS IN QUESTION	genus in question	1
GENUS IN QUESTION, SPECIES IN QUESTION	genus in question, species in question	1
GENUS IN QUOTES	genus in question	1
GENUS IN QUOTES AND ?	genus in question	1
GENUS IN QUOTES, CF GEN	genus in question	1
GENUS IN QUOTES, CF SP	genus in question	1
GENUS IN QUOTES. ? SP	genus in question, species in question	1
GENUS INDET A SP. A	gen. indet.	1
GENUS INDET B SP. A	gen. indet.	1
GENUS QUESTIONED	genus in question	1
GENUS UNCERTAIN, SPECIES UNKNOWN, FAMILY IDENTIFIED	genus in question	1
GENUS, ?SP	genus in question, species in question	1
GENUS, SPECIES AND FAMILY UNCERTAIN	genus in question	1
GIANT SP.	sp.	1
GN ?	genus in question	1
GN ? SP ?	genus in question, species in question	1
GN CF	cf.	1
GN CF SG CF	cf.	1
GN CF SP CF	cf.	1
GN?	genus in question	1
GRANDMARIAE N. SP.	sp. nov.	1
GRAY, 1842		1
GS ?	genus in question	1
GS CF	cf.	1
GULOSUS X SP.	gulosus X sp.	1
HAEMATODUS X EOS SP.	haematodus x Eos sp.	1
HEAD SP. 1	sp.	1
HEAD SP. 2	sp.	1
HIND WING SP. 1	sp.	1
HOLOTYPE LARGER OF 2 SPECIMENS IN JAR		1
HOLOTYPE OF APROSMICTUS ERYTHROPTERUS MELVILLENSIS, ZIETZ, 1914 (SEE SAOA 1(1):14		1
HOLOTYPE OF ASTUR CLARUS ROBUSTUS, ZIETZ, 1914; GREY PHASE, SEE SAOA 1(1):13. W.D. DODD NO. 574.		1
HOLOTYPE OF CHRYSOCOCCYX MINUTILLUS MELVILLENSIS, ZIETZ, 1914 (SEE SAOA 1(1):14. W.D. DODD NO. 666).		1
HOLOTYPE SAMA?? 300MM		1
HYLA SP.	sp.	1
I NOV. GEN. NOV. SP. (GINSBURG 1964)	gen. nov.	1
I. SP. B	sp.	1
ICHNOSP. A	sp.	1
IDENTIFIED		1
INCERTAE SEDIS	incertae sedis	1
INCERTAE SEDIS SP. 1	sp.	1
INCERTAE SEDIS SP. 2	sp.	1
INDET SP.	sp.	1
INDET. NOV. GEN. ET SP.	gen. nov.	1
INDET. SP.	sp.	1
INDET. SP. 1	sp.	1
INDET. SP. 10	sp.	1
INDET. SP. 11	sp.	1
INDET. SP. 12	sp.	1
INDET. SP. 13	sp.	1
INDET. SP. 14	sp.	1
INDET. SP. 15	sp.	1
INDET. SP. 16	sp.	1
INDET. SP. 17	sp.	1
INDET. SP. 18	sp.	1
INDET. SP. 19	sp.	1
INDET. SP. 2	sp.	1
INDET. SP. 20	sp.	1
INDET. SP. 21	sp.	1
INDET. SP. 22	sp.	1
INDET. SP. 23	sp.	1
INDET. SP. 3	sp.	1
INDET. SP. 4	sp.	1
INDET. SP. 5	sp.	1
INDET. SP. 6	sp.	1
INDET. SP. 7	sp.	1
INDET. SP. 8	sp.	1
INDET. SP. 9	sp.	1
INDET. SP. A	sp.	1
INDET. SP. B	sp.	1
INDET. SP. NOV.	sp. nov.	1
INDET. SP. OTHERS	sp.	1
INDET. SP. X	sp.	1
INDET. SP. Y	sp.	1
INDET. SP.1	sp.	1
INDET. SP.2	sp.	1
INDET. SP.3	sp.	1
INFORMAL	informal	1
INORNATUS X SP. UNIPARENS	inornatus x sp.	1
ISOLEPIS SP.1	sp.	1
ISOLEPIS SP.2	sp.	1
ISP.	sp.	1
JANITOR N. SP.	sp. nov.	1
JASONI N. SP.	sp. nov.	1
JUV. NOV. SP.	sp. nov.	1
JUVENILE		1
JUVENILE?		1
KOBELTI N. SP.	sp. nov.	1
L=170M.M.		1
LARGE		1
LARGE CORALLA SP.	sp.	1
LARGE SMOOTH SP.	sp.	1
LARGE SP.	sp.	1
LARVA SP.	sp.	1
LARVA SP. 1	sp.	1
LARVA SP. 2	sp.	1
LARVA SP. 3	sp.	1
LARVA SP. 4	sp.	1
LARVA SP. 5	sp.	1
LARVAE SP. 7	sp.	1
LARVAE SP. 8	sp.	1
LEPOSTERNON SP.	sp.	1
LEUCIODUS X SP.	leuciodus X sp.	1
LEVINAE N. SP.	sp. nov.	1
LJH MAGNOLIA SP.1	sp.	1
LJH MAGNOLIA SP.2	sp.	1
LJH N.SP.IIIA	sp.	1
LJH N.SP.IV	sp.	1
LJH N.SP.IVA	sp.	1
LJH N.SP.VII	sp.	1
LJH N.SP.X	sp.	1
LJH N.SP.XIV	sp.	1
LJH N.SP.XIX	sp.	1
LJH N.SP.XV	sp.	1
LJH N.SP.XVII	sp.	1
LJH N.SP.XVIII	sp.	1
LJH N.SP.XX	sp.	1
LJH N.SP.XXI	sp.	1
LJH N.SP.XXIX	sp.	1
LJH N.SP.XXX	sp.	1
LJH N.SP.XXXI	sp.	1
LOBATE SP.	sp.	1
LOBATUM N. SP.	sp. nov.	1
LOBOSCULUMSP.	sp.	1
LUTRENSA X SP.	lutrensa X sp.	1
MACROCHIRUS X SP.	macrochirus X sp.	1
MALE		1
MALTHE X SP.	malthe x sp.	1
MANY RIDGES SP.	sp.	1
MARTINIA OR RETICULARIA SP.	sp.	1
MAULDINENSIS SP. NOV.	sp. nov.	1
MEDIUM SIZED SP.	sp.	1
MEGALOTIS X SP.	megalotis X sp.	1
METASTERNITE SP. 1	sp.	1
MICROPOGONIASSP.	sp.	1
MOAI N. SP.	sp. nov.	1
N SP.	sp. nov.	1
N SP. "L402"	sp. nov.	1
N SP. A	sp. nov.	1
N SP. B	sp. nov.	1
N. GEN. ET. SP.	gen. nov.	1
N. GEN. N. SP.	gen. nov.	1
N. SP.	sp. nov.	1
N. SP.  B	sp. nov	1
N. SP. #1	sp. nov.	1
N. SP. #2	sp. nov.	1
N. SP. (CF. ACHIRUS)	sp. nov.	1
N. SP. (CF. FITZSIMONSI)	sp. nov.	1
N. SP. (CF. PUSILLUS)	sp. nov.	1
N. SP. (CF. REGANI)	sp. nov.	1
N. SP. (CF. SIGNIFERA)	sp. nov.	1
N. SP. (CF. THETA)	sp. nov.	1
N. SP. (MS)	sp. nov.	1
N. SP. (YUCATANA GROUP)	sp. nov.	1
N. SP. [BLUE-SPOTTED]	sp. nov.	1
N. SP. “BIMACULATUS”	sp. nov.	1
N. SP. “CONGO”	sp. nov.	1
N. SP. “NEGRO/ALTO ORINOCO”	sp. nov.	1
N. SP. “RUFIJI”	sp. nov.	1
N. SP. “TAILSPOT”	sp. nov.	1
N. SP. 1	sp. nov.	1
N. SP. 10	sp. nov.	1
N. SP. 11	sp. nov.	1
N. SP. 12	sp. nov.	1
N. SP. 13	sp. nov.	1
N. SP. 2	sp. nov.	1
N. SP. 3	sp. nov.	1
N. SP. 4	sp. nov.	1
N. SP. 5	sp. nov.	1
N. SP. 6	sp. nov.	1
N. SP. 6.	sp. nov	1
N. SP. 7	sp. nov.	1
N. SP. 8	sp. nov.	1
N. SP. 9	sp. nov.	1
N. SP. A	sp. nov.	1
N. SP. A.	sp. nov.	1
N. SP. B	sp. nov.	1
N. SP. B (SHORT GLAND)	sp. nov.	1
N. SP. B.	sp. nov.	1
N. SP. C	sp. nov.	1
N. SP. CF. INCONSPICUA	sp. nov.	1
N. SP. CF. MACKAYI	sp. nov.	1
N. SP. CF. WYOMINGENSIS	sp. nov	1
N. SP. D	sp. nov.	1
N. SP. D OF KLAPPER	sp. nov.	1
N. SP. E	sp. nov	1
N. SP. E OF KLAPPER	sp. nov	1
N. SP. F OF KLAPPER	sp. nov	1
N. SP. I	sp. nov	1
N. SP. J	sp. nov.	1
N. SP. KUES & BATTEN 2001	sp. nov.	1
N. SP. L	sp. nov.	1
N. SP. M	sp. nov.	1
N. SP. MS	sp. nov.	1
N. SP. N	sp. nov.	1
N. SP. OF KUES 1984	sp. nov	1
N. SP. Q	sp. nov.	1
N. SP. QUE. CHARANAL	sp. nov.	1
N. SP. R	sp. nov.	1
N. SP. SALOTTI ET AL. 1997	sp. nov.	1
N. SP.2	sp. nov.	1
N. SP.3	sp. nov.	1
N. SP.4	sp. nov.	1
N. SP.A	sp. nov	1
N.SP.	sp. nov.	1
N.SP. "COMMON"	sp. nov.	1
N.SP. "TAVI"	sp. nov.	1
N.SP. (CF. RETICULATUS)	sp. nov.	1
N.SP. (MS)	sp. nov.	1
N.SP. 1	sp. nov.	1
N.SP. 2	sp. nov.	1
N.SP. 3	sp. nov.	1
N.SP. 4	sp. nov	1
N.SP. 9	sp. nov.	1
N.SP. A	sp. nov.	1
N.SP. CF NOVAECALEDONIAE	sp. nov.	1
N.SP. 'COMMON'	sp. nov.	1
N.SP. CORAL SEA	sp. nov.	1
N.SP.1	sp. nov.	1
N.SP.2	sp. nov.	1
N.SP.3	sp. nov.	1
N.SP.SP.2	sp. nov.	1
N.SP.SP.3	sp. nov.	1
N.SP.SP.5	sp. nov.	1
N.SP.SP.7	sp. nov.	1
NEAR SP	cf.	1
NEAR SP.	cf.	1
NEW SP.	sp. nov.	1
NEW SP. 1	sp. nov.	1
NEW SP. 2	sp. nov.	1
NOT ID-ABLE TO SP. (WEIL 2004)	sp.	1
NOV GEN. NOV SP.2	gen. nov.	1
NOV SP.1	sp. nov.	1
NOV. GEN. NOV. SP.2	gen. nov.	1
NOV. SP.	sp. nov.	1
NOV. SP. 1	sp. nov	1
NOV. SP. 1 AFF. PRISCUS	sp. nov	1
NOV. SP. 2	sp. nov	1
NOV. SP. 2 AFF. PRISCUS	sp. nov	1
NOV. SP. 3	sp. nov	1
NOV. SUBSP.	ssp. nov.	1
NOVECRINITA N.	sp. nov.	1
NR	cf.	1
NR GN	cf.	1
NR SP	cf.	1
NR.	cf.	1
NSP. 6	sp. nov.	1
NYMPH SP. 1	sp.	1
NYMPH SP. 2	sp.	1
OI ?	id in question	1
OI CF	id in question	1
OKADAI N. SP.	sp. nov.	1
OKRA SP.1	sp.	1
OR ?	order in question	1
OR ? ;FA ?	order, family in question	1
OR ? ;FA ? ;GE ?	order, family, genus in question	1
OR ? ;SP ?	order in question	1
OR ? ;SP CF	order in question	1
OR ?, FA ?	order, family in question	1
OR ?, WORN	order in question	1
OR ?; FA ?	order, family in question	1
OR ?; SP ?	order in question	1
OR CARNIVORA	order in question	1
OR CF	cf.	1
OR M. SEMINOENSIS	species in question	1
OR NR	cf.	1
OR PLIOHIPPUS	genus in question	1
OREAS X NOCOMIS SP.	oreas x Nocomis sp.	1
OTOPHRYNE SP.	sp.	1
OVOPHIS MONTICOLO (GÜNTHER, 1964)		1
PALM SP. 1	palm sp. 1	1
PALM SP.1	palm sp.1	1
PANDORA X R. SP.	pandora X R. sp.	1
PATZNERI N. SP.	sp. nov.	1
PAULSONI SSP. TASMAI	ssp.	1
PERLATES (SUBSP.)	ssp.	1
PIPILODRYAS SP.	sp.	1
PLEXA SSP. S	ssp.	1
POSSIBLY GEN	genus in question	1
POSSIBLY GEN +SP	genus, species in question	1
POSSIBLY SP.	species in question	1
POTOMACENSIS SP. NOV.	sp. nov.	1
PROBABLE	id in question	1
PROBABLY	id in question	1
PROMOTUM SP. 1	sp.	1
PRONOTUM SP. 1	sp.	1
PRONOTUM SP. 2	sp.	1
PROSERPINA X NOTROPIS SP.	proserpina X Notropis sp.	1
PSEUDOLATOCHARA SP. – LATOCHARA SP.	Pseudolatochara sp. – Latochara sp.	1
PUPA SP. 2	sp.	1
PUPAE SP. 1	sp.	1
PUPAE SP. 3	sp.	1
PUPAE SP. 4	sp.	1
PUPAE SP. 5	sp.	1
PUPAE SP. 6	sp.	1
Q SP	species in question	1
QUADRIMUCRONATUS SSP. INDET.	ssp.	1
RAMOSE SP.	sp.	1
REGANI (N. SSP.)	ssp. nov.	1
REGULARIS X SP.	regularis x sp.	1
REMARKS:2 = W.D. DODD. NO. 451.B1002, B1003 PARATYPES OF PACHYCEPHALA RUFIVENTRIS MINOR, ZIETZ, 1914 (SEE SAOA 1(1):15. W.D. DODD NO. 519.		1
RHAMNOPHYLL SP.1	sp.	1
RHINA,BINOCULATA,INORNATA	species in question	1
RW SP. 18	sp.	1
RW SP. 23	sp.	1
RW SP. 25	sp.	1
RW SP. 26	sp.	1
RW SP. 28	sp.	1
RW SP. 34	sp.	1
RW SP. 50	sp.	1
RW SP. 62	sp.	1
RW SP. 68	sp.	1
RW SP.36	sp.	1
RW SP.50	sp.	1
RW SP.62	sp.	1
RW SP.63	sp.	1
S. ELLIOTI X G. SP.	S. ellioti X G. sp.	1
S.L.SP.	sp.	1
SAMARA-SP. 2	sp.	1
SAMARA-SP.2	sp.	1
SCINAX LESCUREI SP. NOV.	sp. nov.	1
SEE NOTES FOR REFERENCES		1
SEED GEN. A SP. A	gen. indet.	1
SEED GEN. A SP. B	gen. indet.	1
SEED GEN. B SP. A	gen. indet.	1
SEED GEN. B SP. B	gen. indet.	1
SEED GEN. C SP. A	gen. indet.	1
SEED GEN. D SP. A	gen. indet.	1
SENSU LATO	sensu lato	1
SG ?	genus, species in question	1
SG CF	cf.	1
SG CF;SP CF	cf.	1
SIGMODONTINAE		1
SMALL		1
SMALL SP.	sp.	1
SMOOTH SP.	sp.	1
SOME UNCERTAINTY AS TO IDENTIFICATION	id in question	1
SP	sp.	1
SP ?	species in question	1
SP CF	cf.	1
SP CF. SS CF	cf.	1
SP CF; WORN	cf.	1
SP D	sp.	1
SP NEAR	cf.	1
SP NR	cf.	1
SP.	sp.	1
SP.  A	sp.	1
SP.  SCI 170	sp.	1
SP. "6"	sp. nov.	1
SP. "A"		1
SP. "ATROX/PATROX"	sp.	1
SP. "B"	sp.	1
SP. "B&W"	sp.	1
SP. "B+W"	sp.	1
SP. "BIG EYES"	sp.	1
SP. "BLACK&WHITE"	sp.	1
SP. "BLOTCH"	sp.	1
SP. "BROAD STRIPE"	sp.	1
SP. "C"	sp.	1
SP. "CORTA"	sp.	1
SP. "DARK SPOTS"	sp.	1
SP. "FLAT"	sp.	1
SP. "FRECKLED"	sp.	1
SP. "HUMPHEAD"	sp.	1
SP. "KAZUMBE"	sp.	1
SP. "LINEA"	sp.	1
SP. "LONG ADIPOSE FIN"	sp.	1
SP. "MARBLED"	sp.	1
SP. "MOSHI"	sp.	1
SP. "MOTTLED"	sp.	1
SP. "ORIENTAL VIPERS COMPLEX"	sp.	1
SP. "PINTADO"	sp.	1
SP. "SADDLE"	sp.	1
SP. "SAWFIN SHINER"	sp.	1
SP. "SHORT ADIPOSE FIN"	sp.	1
SP. "URIQUE"	sp.	1
SP. "WALTERI"	sp.	1
SP. "WHITE CAUDAL EDGE"	sp.	1
SP. # 1	sp.	1
SP. #1	sp.	1
SP. #2	sp.	1
SP. #4	sp.	1
SP. ("ASPIS" COMPLEX)	sp.	1
SP. ("ORIENTAL VIPER" GROUP)	sp.	1
SP. (? ALBA)	sp.	1
SP. (? AZUREUS)	sp.	1
SP. (? FERNANDEZIANUS)	sp.	1
SP. (? HOLLANDI)	sp.	1
SP. (? LISPUS)	sp.	1
SP. (? N. SP.)	sp.	1
SP. (? NEWNESI)	sp.	1
SP. (? SINENSIS)	sp.	1
SP. (?PALUMBUS)	sp.	1
SP. (“EUROPEAN VIPERS” GROUP: “VIPERA ASPIS COMPLEX”)	sp.	1
SP. (“ORIENTAL VIPERS” GROUP)	sp.	1
SP. (A)	sp.	1
SP. (ALBINO)	sp.	1
SP. (ALNORUM OR TRAILLI ?)	sp.	1
SP. (ALTAMAZONICA COMPLEX)	sp.	1
SP. (AMMOCEOTES)	sp.	1
SP. (AMMOCOETE)	sp.	1
SP. (AMMOCOETES)	sp.	1
SP. (ARFAKIANA GROUP)	sp.	1
SP. (B)	sp.	1
SP. (BASIN FORM)	sp.	1
SP. (BICOLOR COMPLEX)	sp.	1
SP. (BOGOTENSIS GROUP)	sp.	1
SP. (BRANCHING)	sp.	1
SP. (BROAD HEAD)	sp.	1
SP. (BROADTAIL MADTOM)	sp.	1
SP. (C)	sp.	1
SP. (C.F. EUROPAEUS)	sp.	1
SP. (CALAMARINA-GROUP)	sp.	1
SP. (CATHARINAE-GROUP)	sp.	1
SP. (CAURA, ORINOCO)	sp.	1
SP. (CEPHALICA-CLADE)	sp.	1
SP. (CF. BREVISPINIS)	cf. brevispinis	1
SP. (CF. EOS)	cf. eos	1
SP. (CF. FLAVOBRUNNEUS)	cf. flavobrunneus	1
SP. (CF. LIMBATUS)	cf. limbatus	1
SP. (CF. MEDITERRANEUS)	cf. mediterraneus	1
SP. (CF. MELANOSTOMA)	cf. melanostoma	1
SP. (CF. MINUTILUS)	cf. minutilus	1
SP. (CF. MOLLIS)	cf. mollis	1
SP. (CF. PARADOXUM)	cf. paradoxum	1
SP. (CF. PLATOPHRYS)	cf. platophrys	1
SP. (CF. PULCHER)	cf. pulcher	1
SP. (CF. VALDIVIAE)	cf. valdiviae	1
SP. (CF. VEXILLARIS)	cf. vexillaris	1
SP. (CHALCONOTA-GROUP)	cf. vexillaris	1
SP. (COARSE RIBS)	sp.	1
SP. (COCOS LONG-NOSE)	sp.	1
SP. (COELOMYS)	sp.	1
SP. (D)	sp.	1
SP. (DENDRITICUS ?)	sp.	1
SP. (DRACO GROUP)	sp.	1
SP. (E)	sp.	1
SP. (E. UMBRINUS OR E. QUADRIVITTATUS)	sp.	1
SP. (EBELINGI ?)	species in question	1
SP. (ENCRUSTING)	sp.	1
SP. (F)	sp.	1
SP. (FUSCOAURATUS-GROUP)	sp.	1
SP. (FUSCUS COMPLEX)	sp.	1
SP. (GRAMMICUS-GROUP)	sp.	1
SP. (GROUP I)	sp.	1
SP. (GROUP II)	sp.	1
SP. ('GROUP II')	sp.	1
SP. (GROUP III)	sp.	1
SP. (HOLSTON)	sp.	1
SP. (HYBRID)	sp.	1
SP. (HYBRID?)	sp.	1
SP. (JOBIENSIS GROUP)	sp.	1
SP. (LARVA)	sp.	1
SP. (LATERALIS GROUP)	sp.	1
SP. (LEMNISCATUS-GROUP)	sp.	1
SP. (LESUEURII COMPLEX)	sp.	1
SP. (MACCONNELLI / OLEAGINEUS)	sp.	1
SP. (MACRONEMA)	sp.	1
SP. (MARGARITIFERA-COMPLEX)	sp.	1
SP. (MELANOLEUCUS-GROUP)	sp.	1
SP. (MELANONOTUS GROUP)	sp.	1
SP. (MIGRANS?)	sp.	1
SP. (NOTATUS-GROUP)	sp.	1
SP. (OCELLATUS-GROUP)	sp.	1
SP. (OCELLIFER-GROUP)	sp.	1
SP. (OCHROPHAEUS-COMPLEX)	sp.	1
SP. (PAPUA GROUP)	sp.	1
SP. (PARVICEPS GROUP)	sp.	1
SP. (PEREGRINA OR RUFICAPILLA ?)	sp.	1
SP. (PERPUSILLUS GROUP)	sp.	1
SP. (PHILADELPHIA X TOLMEI)	philadelphia X tolmei	1
SP. (PINK)	sp.	1
SP. (PIPIENS COMPLEX)	sp.	1
SP. (PODICIPINUS-WAGNERI COMPLEX)	sp.	1
SP. (POOR CONDITION)	sp.	1
SP. (POSSIBLY BIFILIS)	sp.	1
SP. (POSSIBLY TOLMIEI)	sp.	1
SP. (PRATTI GROUP)	sp.	1
SP. (PROB. HYBRID ELEGANS X FLAVEOLUS)	sp.	1
SP. (QUECHUA-GROUP)	sp.	1
SP. (REDBAND)	sp.	1
SP. (RK SP3)	sp.	1
SP. (RUBER GROUP)	sp.	1
SP. (SAJORI)	sp.	1
SP. (SCHMIDTI-GROUP)	sp.	1
SP. (SHAG)	sp.	1
SP. (SPECIOSA OR TRICHAS)	sp.	1
SP. (SPUMARIUS-COMPLEX)	sp.	1
SP. (STANLEYANA GROUP)	sp.	1
SP. (STAURIPHORA)	sp.	1
SP. (TAENIURA)	sp.	1
SP. (TALLAPOOSA SCULPIN)	sp.	1
SP. (TEMPORARIA-GROUP)	sp.	1
SP. (TRAILII / ALNORUM [?])	sp.	1
SP. (TYPE A)	sp.	1
SP. (TYPE B)	sp.	1
SP. (URUNGUENSIS-GROUP)	sp.	1
SP. (VARIEGATUS-GROUP)	sp.	1
SP. (VIPERA ASPIS COMPLEX)	sp.	1
SP. (VIPERA BERUS COMPLEX)	sp.	1
SP. (WHITE)	sp.	1
SP. (XANTHA MS)	sp.	1
SP. (YELLOW)	sp.	1
SP. ?	species in question	1
SP. ??	species in question	1
SP. ???	species in question	1
SP. [? TERMINATA]	cf. terminata	1
SP. “ADIPOSA LARGA”	sp.	1
SP. “BANDED”	sp.	1
SP. “BROWN”	sp.	1
SP. “BRYCONAMERICUS”	sp.	1
SP. “BULLOCKI”	sp.	1
SP. “CHATA”	sp.	1
SP. “CHATTA”	sp.	1
SP. “CHEIRODON”	sp.	1
SP. “CIRCLE E”	sp.	1
SP. “COMMA”	sp.	1
SP. “COMMON”	sp.	1
SP. “DARK”	sp.	1
SP. “DEEP BODY”	sp.	1
SP. “DITTO”	sp.	1
SP. “DORSAL SPOT”	sp.	1
SP. “DORSAL WHITE SPOTS”	sp.	1
SP. “ESSEQUIBO”	sp.	1
SP. “FLAT”	sp.	1
SP. “FUSED SADDLES”	sp.	1
SP. “GHOST”	sp.	1
SP. “GUAPUCHE”	sp.	1
SP. “HALF STRIPE”	sp.	1
SP. “HUGE SCALES”	sp.	1
SP. “INCOMPLETE”	sp.	1
SP. “IRENG”	sp.	1
SP. “LINE”	sp.	1
SP. “LONG”	sp.	1
SP. “MEMBRANE”	sp.	1
SP. “MUSCADINE DARTER”	sp.	1
SP. “MUY LARGA”	sp.	1
SP. “NO SPOT”	sp.	1
SP. “NO SPOTS”	sp.	1
SP. “NO STRIPE”	sp.	1
SP. “ORANGE HUMERAL”	sp.	1
SP. “PLAIN”	sp.	1
SP. “PSEUDO-BROWNI”	sp.	1
SP. “PSEUDOGEPHYROCHARAX”	sp.	1
SP. “PSEUDOMICROSTOMUS”	sp.	1
SP. “SAWFIN SHINER”	sp.	1
SP. “SHORT ANAL FIN”	sp.	1
SP. “SHORT”	sp.	1
SP. “SILVER STRIPE”	sp.	1
SP. “SLENDER”	sp.	1
SP. “SLIM”	sp.	1
SP. “SMALL SADDLE”	sp.	1
SP. “SPOT”	sp.	1
SP. “SPOTS IN STRIPE”	sp.	1
SP. “STRIPETAIL”	sp.	1
SP. “TAKUTU 2”	sp.	1
SP. “TAKUTU”	sp.	1
SP. “TENCUANENSIS”	sp.	1
SP. “UPPER CAUDAL SPOT”	sp.	1
SP. “VENTUARI”	sp.	1
SP. “WHITE DOTS”	sp.	1
SP. “WIDE LINE”	sp.	1
SP. “WIDE STRIPE”	sp.	1
SP. “YUPUKARI”	sp.	1
SP. <20 MICROMETERS	sp.	1
SP. <29 MICROMETERS	sp.	1
SP. 1	sp.	1
SP. '1'	sp.	1
SP. 1 – SP. 5	sp.	1
SP. 1 (CF. MACROPHTHALMA)	cf. macrophthalma	1
SP. 1 (LARGE)	sp.	1
SP. 1 AFF. LIRATA	sp.	1
SP. 1 AFF. RADIALIS	sp.	1
SP. 1 GR. COSTATUM	sp.	1
SP. 1 LINDSTRÖM	sp.	1
SP. 1 MORPHOTYPE 13	sp.	1
SP. 1 MORPHOTYPE 7	sp.	1
SP. 1 MORPHOTYPE 8	sp.	1
SP. 1 NOV	sp. nov.	1
SP. 1.	sp.	1
SP. 10	sp.	1
SP. 11	sp.	1
SP. 12	sp.	1
SP. 13	sp.	1
SP. 14	sp.	1
SP. 15	sp.	1
SP. 16	sp.	1
SP. 17	sp.	1
SP. 18	sp.	1
SP. 19	sp.	1
SP. 2	sp.	1
SP. '2'	sp.	1
SP. 2 (SMALL)	sp.	1
SP. 2 AFF EMARGINATA	sp.	1
SP. 2 AFF. CHAOI	sp.	1
SP. 2 AFF. RADIALIS	sp.	1
SP. 2 GR. COSTATUM	sp.	1
SP. 2 LARVA	sp.	1
SP. 2 MORPHOTYPE 14	sp.	1
SP. 2 MORPHOTYPE 9	sp.	1
SP. 2 RETICULATE	sp.	1
SP. 2.	sp.	1
SP. 20	sp.	1
SP. 21	sp.	1
SP. 22	sp.	1
SP. 23	sp.	1
SP. 24	sp.	1
SP. 25	sp.	1
SP. 26	sp.	1
SP. 27	sp.	1
SP. 28	sp.	1
SP. 29	sp.	1
SP. 3	sp.	1
SP. 3 - COLORADO	sp.	1
SP. 3 (CF. ORIENTALIS)	cf. orientalis	1
SP. 30	sp.	1
SP. 303	sp.	1
SP. 304	sp.	1
SP. 305 LONGIMANUS	sp.	1
SP. 306 (PARACANTHUS)	sp.	1
SP. 307 (BILINEATUS)	sp.	1
SP. 308 (COMATUS)	sp.	1
SP. 309 (RECTISETUS)	sp.	1
SP. 31	sp.	1
SP. 311	sp.	1
SP. 312	sp.	1
SP. 314 XAVIERFILHOI	sp.	1
SP. 316 HOLDENAE	sp.	1
SP. 319 MARINHOI	sp.	1
SP. 32	sp.	1
SP. 324	sp.	1
SP. 325	sp.	1
SP. 326 AMATI	sp.	1
SP. 328 RICCARDIAE	sp.	1
SP. 33	sp.	1
SP. 330	sp.	1
SP. 338 NOCTURNIGRUS	sp.	1
SP. 34	sp.	1
SP. 35	sp.	1
SP. 36	sp.	1
SP. 37	sp.	1
SP. 38	sp.	1
SP. 39	sp.	1
SP. 3B	sp.	1
SP. 3C	sp.	1
SP. 3D	sp.	1
SP. 3F	sp.	1
SP. 3G	sp.	1
SP. 3H	sp.	1
SP. 3I	sp.	1
SP. 3J	sp.	1
SP. 3K	sp.	1
SP. 3L	sp.	1
SP. 3M	sp.	1
SP. 3N	sp.	1
SP. 3O	sp.	1
SP. 3P	sp.	1
SP. 4	sp.	1
SP. 4 DFH	sp.	1
SP. 40	sp.	1
SP. 41	sp.	1
SP. 42	sp.	1
SP. 43	sp.	1
SP. 44	sp.	1
SP. 45	sp.	1
SP. 46	sp.	1
SP. 47	sp.	1
SP. 48	sp.	1
SP. 49	sp.	1
SP. 5	sp.	1
SP. 5 "WA ALLPORTI"	sp.	1
SP. 5 AFF. WAAGENI	sp.	1
SP. 50	sp.	1
SP. 51	sp.	1
SP. 52	sp.	1
SP. 53	sp.	1
SP. 54	sp.	1
SP. 55	sp.	1
SP. 56	sp.	1
SP. 57	sp.	1
SP. 58	sp.	1
SP. 59	sp.	1
SP. 6	sp.	1
SP. 6.	sp.	1
SP. 60	sp.	1
SP. 62	sp.	1
SP. 7	sp.	1
SP. 7 DFH	sp.	1
SP. 7 PUPA	sp.	1
SP. 7A	sp.	1
SP. 8	sp.	1
SP. 9	sp.	1
SP. 9 DFH	sp.	1
SP. 9 PUPA	sp.	1
SP. A	sp.	1
SP. A  (N. SP.)	sp. nov.	1
SP. A AFF. GRANULOSUS	aff. granulosus	1
SP. A CASIER AND LETHIERS 1998	sp.	1
SP. A CASIER AND LETHIERS, 1998	sp.	1
SP. A CF. PSEUDOFORBESI	cf. pseudoforbesi	1
SP. A JOHNSON	sp.	1
SP. A OF BOYCE 1989	sp.	1
SP. A OF MCKELLAR	sp.	1
SP. A SENSU BENGTSON 1990	sp.	1
SP. A SENSU RISTEDT	sp.	1
SP. A SENSUS BECKER (1971)	sp.	1
SP. A WITZKE 1976	sp.	1
SP. A WITZKE AND STRIMPLE	sp.	1
SP. A.	sp.	1
SP. A. WILLIAMS IN WILLIAMS ET AL. 1987	sp.	1
SP. A/C	sp.	1
SP. A0	sp.	1
SP. A02	sp.	1
SP. A1	sp.	1
SP. A2	sp.	1
SP. A3	sp.	1
SP. A4	sp.	1
SP. A5	sp.	1
SP. A6	sp.	1
SP. A-C	sp.	1
SP. A-D	sp.	1
SP. AFF. ATTENUATUM TYPE 2	sp.	1
SP. AFF. FURCATUM TYPE 1	sp.	1
SP. AFF. GALAXIAS	aff. galaxias	1
SP. AFF. JAEGERSTENI TYPE 1	sp.	1
SP. AFF. LAVENBERGI	aff. lavenbergi	1
SP. AFF. LYSINA	aff. lysina	1
SP. AFF. MARINUS	aff. marinus	1
SP. AFF. PUNCTITAENIATUS	aff. punctitaeniatus	1
SP. ALBOGULARIS	sp.	1
SP. ALPHA	sp.	1
SP. AR4	sp.	1
SP. B	sp.	1
SP. B (D?)	sp.	1
SP. B AFF. GRANULOSUS	aff. granulosus	1
SP. B CF. PARAFORBESI	cf. paraforbesi	1
SP. B IMBRIE	sp.	1
SP. B LETHIERS AND CASIER 1996	sp.	1
SP. B SENSU RISTEDT	sp.	1
SP. B SENSU WIDZ 1991	sp.	1
SP. B WITZKE 1976	sp.	1
SP. B WITZKE AND STRIMPLE	sp.	1
SP. B, GEN. AND SP. INDET.	gen. indet.	1
SP. B.	sp.	1
SP. B0	sp.	1
SP. B01	sp.	1
SP. B1	sp.	1
SP. B2	sp.	1
SP. B3	sp.	1
SP. B4	sp.	1
SP. B5	sp.	1
SP. BBN1	sp.	1
SP. BBP1	sp.	1
SP. BBP2	sp.	1
SP. BBP3	sp.	1
SP. BENNETTI	sp.	1
SP. 'BLUESTONE SCULPIN'	sp.	1
SP. BONGOLONENSIS	sp.	1
SP. 'BRINDISI'	sp.	1
SP. 'BROADTAIL'	sp.	1
SP. BSN1	sp.	1
SP. BSN2	sp.	1
SP. BSN9	sp.	1
SP. BSNX	sp.	1
SP. BSP1	sp.	1
SP. BSP2	sp.	1
SP. BSP4	sp.	1
SP. BUTLER	sp.	1
SP. 'BUTTERFLY'	sp.	1
SP. C	sp.	1
SP. C BRANSON 1937	sp.	1
SP. C WITZKE AND STRIMPLE	sp.	1
SP. C&K	sp.	1
SP. C.	sp.	1
SP. C.F. ARCTICUS	cf. arcticus	1
SP. C.F. CARBONARIA	cf. carbonaria	1
SP. C.F. NIGROFASCIATA	cf. nigrofasciata	1
SP. C0	sp.	1
SP. C1	sp.	1
SP. C2	sp.	1
SP. C3	sp.	1
SP. CF PTEROIDES	cf. pteroides	1
SP. CF.	cf.	1
SP. CF. AESTIVALIS	cf. aestivalis	1
SP. CF. AESTIVALIS “A”	cf. aestivalis	1
SP. CF. AESTIVALIS “B”	cf. aestivalis	1
SP. CF. AESTIVALIS “C”	cf. aestivalis	1
SP. CF. AESTIVALIS A	cf. aestivalis	1
SP. CF. AESTIVALIS B	cf. aestivalis	1
SP. CF. AESTIVALIS C	cf. aestivalis	1
SP. CF. AESTIVALIS D	cf. aestivalis	1
SP. CF. AESTIVALIS 'D'	cf. aestivalis	1
SP. CF. ALBIFIMBRIA	cf. albifimbria	1
SP. CF. ALFARI	cf. alfari	1
SP. CF. ASPERIFRONS	cf. asperifrons	1
SP. CF. ASPRIGENE	cf. asprigene	1
SP. CF. AUREUM	cf. aureum	1
SP. CF. AUSTRINUM	cf. austrinum	1
SP. CF. BAIRDI	cf. bairdi	1
SP. CF. BAIRDI 'HUBBSI'	cf. bairdi	1
SP. CF. BAIRDI 'SMOKY'	cf. bairdi	1
SP. CF. BAIRDII	cf. bairdii	1
SP. CF. BALTEATUS	cf. balteatus	1
SP. CF. BARDI	cf. bairdi	1
SP. CF. BELDINGI	cf. beldingi	1
SP. CF. BELLATOR	cf. bellator	1
SP. CF. BUCHIANUS	cf. buchianus	1
SP. CF. CAERULEOMENTUM	cf. caeruleomentum	1
SP. CF. CAERULEUM	cf. caeruleum	1
SP. CF. CAPRODES	cf. caprodes	1
SP. CF. CARBONARIA	cf. carbonaria	1
SP. CF. CAROLINAE	cf. carolinae	1
SP. CF. CLARKI	cf. clarki	1
SP. CF. COGNATUS	cf. cognatus	1
SP. CF. COOSAE	cf. coosae	1
SP. CF. CUBANA	cf. cubana	1
SP. CF. CYPRINUS	cf. cyprinus	1
SP. CF. CYPRINUS X VELIFER	cf. cyprinus x velifer	1
SP. CF. CYRANO	cf. cyrano	1
SP. CF. DITREMA	cf. ditrema	1
SP. CF. DURYI	cf. duryi	1
SP. CF. ELONGATUS	cf. elongatus	1
SP. CF. EPISCOPA	cf. episcopa	1
SP. CF. ERYTHROGASTER	cf. erythrogaster	1
SP. CF. FENESTRATUM	cf. fenestratum	1
SP. CF. FLORIDAE	cf. floridae	1
SP. CF. GAGEI	cf. gagei	1
SP. CF. HEMIURUS	cf. hemiurus	1
SP. CF. HYPSELOPTERUS	cf. hypselopterus	1
SP. CF. LACHNERI	cf. lachneri	1
SP. CF. LENTIGNOSUM	cf. lentignosum	1
SP. CF. LEPTACANTHUS	cf. leptacanthus	1
SP. CF. LEUCIODUS	cf. leuciodus	1
SP. CF. LONGIROSTRIS	cf. longirostris	1
SP. CF. MACROCEPHALA	cf. macrocephala	1
SP. CF. MACULATA	cf. maculata	1
SP. CF. MELANONOTATA	cf. melanonotata	1
SP. CF. MUNITUS	cf. munitus	1
SP. CF. MYKISS	cf. mykiss	1
SP. CF. OCCIDENTALIS	cf. occidentalis	1
SP. CF. P. RETUSUM	cf. retusum	1
SP. CF. PALMARIS	cf. palmaris	1
SP. CF. PANTOSTICTUM	cf. pantostictum	1
SP. CF. PARVUS	cf. parvus	1
SP. CF. PECTINOIDES	cf. pectinoides	1
SP. CF. PHAETON	cf. phaeton	1
SP. CF. PLATICEPS	cf. platiceps	1
SP. CF. POECILURUM	cf. poecilurum	1
SP. CF. PUNCTULATUM	cf. punctulatum	1
SP. CF. RAMSEYI	cf. ramseyi	1
SP. CF. RHYTISMA	cf. rhytisma	1
SP. CF. RUBELLUS	cf. rubellus	1
SP. CF. SALAMANQUENSIS	cf. salamanquensis	1
SP. CF. SALAMANQUESIS	cf. salamanquesis	1
SP. CF. SAPO	cf. sapo	1
SP. CF. SAYLORI	cf. saylori	1
SP. CF. SEPTEMFASCIATUM	cf. septemfasciatum	1
SP. CF. SOLLASI	cf. sollasi	1
SP. CF. SPECTABILE	cf. spectabile	1
SP. CF. SPECTRUNCULUS	cf. spectrunculus	1
SP. CF. STIGMAEUM	cf. stigmaeum	1
SP. CF. SWAINI	cf. swaini	1
SP. CF. VELIFER	cf. velifer	1
SP. CF. VITREUM	cf. vitreum	1
SP. CF. VITREUS	cf. vitreus	1
SP. CF. VULGARIS	cf. vulgaris	1
SP. CF. WINCHELLI	cf. winchelli	1
SP. CF. ZONISTIUM	cf. zonistium	1
SP. CG	sp.	1
SP. CG-1	sp.	1
SP. CG-2	sp.	1
SP. 'CHACAMAX'	sp.	1
SP. 'CHOMBA'	sp.	1
SP. 'CLINCH SCULPIN'	sp.	1
SP. D	sp.	1
SP. D WITZKE AND STRIMPLE	sp.	1
SP. D.	sp.	1
SP. D0	sp.	1
SP. D1	sp.	1
SP. D2	sp.	1
SP. D3	sp.	1
SP. DEEPLY CONVEX	sp.	1
SP. DELTA	sp.	1
SP. DIV.	sp.	1
SP. E	sp.	1
SP. E WITZKE AND STRIMPLE	sp.	1
SP. E.	sp.	1
SP. E0	sp.	1
SP. E2	sp.	1
SP. 'EBANO'	sp.	1
SP. EGG CASES	sp.	1
SP. ERECT FORM	sp.	1
SP. F	sp.	1
SP. F.	sp.	1
SP. F2	sp.	1
SP. FORME A	sp.	1
SP. G	sp.	1
SP. G PRIME	sp.	1
SP. G.	sp.	1
SP. G0	sp.	1
SP. G1	sp.	1
SP. G2	sp.	1
SP. GAMMA	sp.	1
SP. GP.	sp.	1
SP. GP. 1	sp.	1
SP. GP. 2	sp.	1
SP. GP. 3	sp.	1
SP. GP. 8	sp.	1
SP. GP. 9	sp.	1
SP. 'GRAMMARION' MS	sp.	1
SP. GREEN	sp.	1
SP. H	sp.	1
SP. H SENSU RISTEDT	sp.	1
SP. H.	sp.	1
SP. H0	sp.	1
SP. H2	sp.	1
SP. 'HOLSTON SCULPIN'	sp.	1
SP. HYBRID	sp.	1
SP. I	sp.	1
SP. I OF LINDSTROM	sp.	1
SP. I SENSU RO	EK, 1984	sp.	1
SP. I.	sp.	1
SP. I0	sp.	1
SP. II	sp.	1
SP. II-A	sp.	1
SP. III	sp.	1
SP. INCERT	sp. incert.	1
SP. INCERT.	sp. incert.	1
SP. INDET	sp.	1
SP. INDET.	sp. indet.	1
SP. INDET. 1	sp.	1
SP. INDET. 1-1	sp.	1
SP. INDET. 1-2	sp.	1
SP. INDET. 2	sp.	1
SP. INDET. 3	sp.	1
SP. INDET. 4	sp.	1
SP. INDET. A	sp.	1
SP. INDET. B	sp.	1
SP. INDET. C	sp.	1
SP. INDET. D	sp.	1
SP. INDET. E	sp.	1
SP. INDET.1	sp.	1
SP. INDET.10	sp.	1
SP. INDET.11	sp.	1
SP. INDET.2	sp.	1
SP. INDET.4	sp.	1
SP. INDET.8	sp.	1
SP. IV	sp.	1
SP. J	sp.	1
SP. J SENSU RISTEDT	sp.	1
SP. J.	sp.	1
SP. J0	sp.	1
SP. J2	sp.	1
SP. JUV.	sp.	1
SP. JUVENILE	sp.	1
SP. JY	sp.	1
SP. JZ	sp.	1
SP. K	sp.	1
SP. K SENSU RISTEDT	sp.	1
SP. K.	sp.	1
SP. KIM-2	sp.	1
SP. L	sp.	1
SP. L.	sp.	1
SP. L0	sp.	1
SP. L260	sp.	1
SP. L3	sp.	1
SP. L333	sp.	1
SP. L340	sp.	1
SP. L66	sp.	1
SP. 'LANCEOLATE'	sp.	1
SP. LARGE	sp.	1
SP. LARGE TAIL NOV.SP.A	sp. nov.	1
SP. LARVA	sp.	1
SP. 'LAS FLORES'	sp.	1
SP. LEMON	sp.	1
SP. 'LEMON'	sp.	1
SP. LENTIGRIOSUM	sp.	1
SP. LINEA	sp.	1
SP. 'LINEA'	sp.	1
SP. LISSMANNI	sp.	1
SP. M	sp.	1
SP. M.	sp.	1
SP. M2	sp.	1
SP. MAGNOSTIPES	sp.	1
SP. MEDIUM	sp.	1
SP. MISSING	sp.	1
SP. MORPH A	sp.	1
SP. MORPH B	sp.	1
SP. MORPHOTYPE 15	sp.	1
SP. MORPHOTYPE 16	sp.	1
SP. N	sp.	1
SP. N.	sp.	1
SP. N. 1	sp. nov.	1
SP. N. A	sp. nov.	1
SP. N. B	sp. nov.	1
SP. N. LARGE FORM	sp. nov.	1
SP. NEW	sp. nov.	1
SP. NGOUNIENSIS	sp.	1
SP. NIGRUM	sp.	1
SP. NO. 4	sp.	1
SP. NOV	sp. nov.	1
SP. NOV 2	sp. nov.	1
SP. NOV.	sp. nov.	1
SP. NOV. (CITRINIPECTUS) CLANCY & LAWSON	sp. nov.	1
SP. NOV. (SIRINTARAE)	sp. nov.	1
SP. NOV. (SPINULOSA)	sp. nov.	1
SP. NOV. 1	sp. nov.	1
SP. NOV. 2	sp. nov.	1
SP. NOV. 2	sp. nov.	1
SP. NOV. 3	sp. nov.	1
SP. NOV. A	sp. nov.	1
SP. NOV. A CASIER AND LETHIERS 1998	sp. nov.	1
SP. NOV. A CASIER AND LETHIERS 2000	sp. nov.	1
SP. NOV. A CASIER AND LETHIERS, 2000	sp. nov.	1
SP. NOV. A SENSU CASIER AND LETHIERS (1996)	sp. nov.	1
SP. NOV. AFF. TIBETICA	sp. nov.	1
SP. NOV. ANGUSTIROSTRIS HELLMAYRI	sp. nov.	1
SP. NOV. B	sp. nov.	1
SP. NOV. BONARIENSIS	sp. nov.	1
SP. NOV. C	sp. nov.	1
SP. NOV. FITZPATRICK	sp. nov.	1
SP. NOV. G	sp. nov.	1
SP. NOV. H	sp. nov.	1
SP. NOV. MS	sp. nov.	1
SP. NZO	sp. nov.	1
SP. O	sp.	1
SP. OF "ORIENTAL VIPERS COMPLEX"	sp.	1
SP. OF "VIPERA ASPIS COMPLEX"	sp.	1
SP. OFFOUENSIS	sp.	1
SP. OJO PEQUENO	sp.	1
SP. OKANOENSIS	sp.	1
SP. 'O-LUGUBRIS'	sp.	1
SP. 'O-WALACII'	sp.	1
SP. 'O-WALLACII'	sp.	1
SP. P	sp.	1
SP. PALIDA	sp.	1
SP. PARSEGNIS	sp.	1
SP. PUFFINUS	sp.	1
SP. Q	sp.	1
SP. Q0	sp.	1
SP. R	sp.	1
SP. ROBERTSI	sp.	1
SP. RUFINA	sp.	1
SP. RW-32	sp.	1
SP. S	sp.	1
SP. S. 152	sp.	1
SP. S.CI. 124	sp.	1
SP. S.CL. 428	sp.	1
SP. S2	sp.	1
SP. SCI 170	sp.	1
SP. SCI.124	sp.	1
SP. SCISSOR TAIL	sp.	1
SP. 'SCISSOR TAIL'	sp.	1
SP. SDL.124	sp.	1
SP. SHORT SPINED	sp.	1
SP. 'SICKLEFIN'	sp.	1
SP. 'SINUOUS'	sp.	1
SP. SLENDER	sp.	1
SP. 'SLENDER'	sp.	1
SP. SMALL	sp.	1
SP. SMALL EYE	sp.	1
SP. 'SMALL TEETH'	sp.	1
SP. SMOOTH	sp.	1
SP. 'SMOOTH'	sp.	1
SP. SN3	sp.	1
SP. SN4	sp.	1
SP. SN9	sp.	1
SP. 'SPOTTED'	sp.	1
SP. STRIPED	sp.	1
SP. SUBSP. A	sp.	1
SP. SUBSP. B	sp.	1
SP. SY01	sp.	1
SP. SY02	sp.	1
SP. SY03	sp.	1
SP. SY04	sp.	1
SP. SY05	sp.	1
SP. SY06	sp.	1
SP. SY07	sp.	1
SP. SZABOI	sp.	1
SP. T	sp.	1
SP. T0	sp.	1
SP. T001	sp.	1
SP. T002	sp.	1
SP. T003	sp.	1
SP. T004	sp.	1
SP. T005	sp.	1
SP. T006	sp.	1
SP. T007	sp.	1
SP. T008	sp.	1
SP. T009	sp.	1
SP. T010	sp.	1
SP. T011	sp.	1
SP. T012	sp.	1
SP. T013	sp.	1
SP. T015	sp.	1
SP. T016	sp.	1
SP. T017	sp.	1
SP. T018	sp.	1
SP. T019	sp.	1
SP. T02	sp.	1
SP. T022	sp.	1
SP. T023	sp.	1
SP. T024	sp.	1
SP. T025	sp.	1
SP. T026	sp.	1
SP. T027	sp.	1
SP. T028	sp.	1
SP. T029	sp.	1
SP. T030	sp.	1
SP. T032	sp.	1
SP. TAIL MOYENNE,NOV.SP.B	sp. nov.	1
SP. 'TALLAPOOSA SCULPIN'	sp.	1
SP. 'TEAPA'	sp.	1
SP. TENUICAUDA	sp.	1
SP. 'THICK'	sp.	1
SP. TINY	sp.	1
SP. TIPO A	sp.	1
SP. TIPO B	sp.	1
SP. TIPO C	sp.	1
SP. TS2	sp.	1
SP. TS3	sp.	1
SP. TYPE 1	sp.	1
SP. TYPE I	sp.	1
SP. TYPE II	sp.	1
SP. U	sp.	1
SP. UNDET.	sp.	1
SP. UNDET. 1	sp.	1
SP. UNNAMED	sp.	1
SP. V	sp.	1
SP. VADAMANS	sp.	1
SP. VARIANT	sp.	1
SP. VEL JUGLANS SP.	sp.	1
SP. VII	sp.	1
SP. W	sp.	1
SP. W1	sp.	1
SP. W2	sp.	1
SP. W4	sp.	1
SP. WHITE-CHEST	sp.	1
SP. X	sp.	1
SP. X SP.	sp. X sp.	1
SP. X VENUSTUS	sp. X venustus	1
SP. Y	sp.	1
SP. Z	sp.	1
SP. Z0	sp.	1
SP.	sp.	1
SP., LAGENID	sp.	1
SP..	sp.	1
SP.;	sp.	1
SP.”VENTUARI”	sp.	1
SP.1	sp.	1
SP.10	sp.	1
SP.11	sp.	1
SP.12	sp.	1
SP.1-2	sp.	1
SP.13	sp.	1
SP.14	sp.	1
SP.15	sp.	1
SP.16	sp.	1
SP.17	sp.	1
SP.18	sp.	1
SP.19	sp.	1
SP.2	sp.	1
SP.21	sp.	1
SP.3	sp.	1
SP.4	sp.	1
SP.4 (CF.DIASTEMA)	cf. diastema	1
SP.4.	sp.	1
SP.5	sp.	1
SP.6	sp.	1
SP.7	sp.	1
SP.8	sp.	1
SP.9	sp.	1
SP.A	sp.	1
SP.A.	sp.	1
SP.A`	sp.	1
SP.B	sp.	1
SP.B (CF.BRANSFORDII)	cf. bransfordii	1
SP.B SENSU HULL 1997	sp.	1
SP.C	sp.	1
SP.CF. WINCHELLI	cf. winchelli	1
SP.D	sp.	1
SP.E	sp.	1
SP.F	sp.	1
SP.G	sp.	1
SP.H	sp.	1
SP.I	sp.	1
SP.III (C.F.CRUENTES)	cf. cruentes	1
SP.INDET.	sp.	1
SP.J	sp.	1
SP.JUV.	sp.	1
SP.K	sp.	1
SP.L	sp.	1
SP.M	sp.	1
SP.N	sp.	1
SP.N.	sp.	1
SP.--NOT M. MOGOLLONENSIS	sp.	1
SP.NOV.	sp. nov.	1
SP.NOV.-LAETOLI	sp. nov.	1
SP.O	sp.	1
SP.'O-WALACII'	sp.	1
SP.Q	sp.	1
SP.R	sp.	1
SP.S	sp.	1
SP.SCL.107	sp.	1
SP.T	sp.	1
SP.U	sp.	1
SP.X	sp.	1
SP?	species in question	1
SP?, WORN	species in question	1
SP?; L > 4MM (WEIL 2004)	species in question	1
SP?; NOT AVAILABLE TO GPW	species in question	1
SP?; NOT ID-ABLE TO SP. (WEIL 2004)	species in question	1
SPARVERIA (SUBSP.)	ssp.	1
SPCF	cf.	1
SPECIES IN QUESTION	species in question	1
SPECIES QUESTIONED	species in question	1
SPECIES: "	sp.	1
SPECIES: ?	species in question	1
SPECIES: AFF.	aff.	1
SPECIES: CF.	cf.	1
SPECIES: EX GR.	ex gr.	1
SPECIES: INFORMAL	informal	1
SPECIES: N. SP.	sp. nov.	1
SPECIES: SENSU LATO	sensu lato	1
SPIRALOCUCULLATA SP. INED.	sp	1
SS ?	subspecies in question	1
SS CF	cf.	1
SSP	ssp.	1
SSP.	ssp.	1
SSP.A	ssp.	1
STICTOS N.SP.	sp. nov.	1
SUBADULT		1
SUBADULT?		1
SUBCL. ELASMOBRANCHII		1
SUBGENUS: "		1
SUBGENUS: " | AFF.		1
SUBGENUS: " | CF.		1
SUBGENUS: " | N. SP.	sp. nov.	1
SUBGENUS: ?	subgenus in question	1
SUBGENUS: ? | ?	subgenus in question	1
SUBGENUS: ? | AFF.	aff.	1
SUBGENUS: ? | CF.	cf.	1
SUBGENUS: ? | N. SP.	sp. nov.	1
SUBGENUS: AFF.	aff.	1
SUBGENUS: AFF. | AFF.	aff.	1
SUBGENUS: AFF. | INFORMAL	aff.	1
SUBGENUS: CF.	cf.	1
SUBGENUS: CF. | CF.	cf.	1
SUBGENUS: CF. | INFORMAL	cf.	1
SUBGENUS: EX GR.	ex gr.	1
SUBGENUS: INFORMAL	informal	1
SUBGENUS: INFORMAL | CF.	cf.	1
SUBGENUS: INFORMAL | INFORMAL	informal	1
SUBGENUS: N. SUBGEN.	subgen. nov.	1
SUBGENUS: N. SUBGEN. | CF.	subgen. nov.	1
SUBGENUS: N. SUBGEN. | N. SP.	subgen. nov.	1
SUBORDER= ACANTHUROIDEI		1
SUBSP CF	cf.	1
SUBSP. 	ssp.	1
SUBSP. INDET.	ssp.	1
SUBSPECIES IN QUESTION	subspecies in question	1
SUBSPECIES QUESTIONED	subspecies in question	1
SUBSPECIES UNCERTAIN	subspecies in question	1
SUBTAXON (VIPERA SP. "ORIENTAL VIPERS" OR DABOIA SP.)	genus in question	1
SULCATE SP.	sp.	1
SUSANAE N. SP.	sp. nov.	1
TABIRA SSP. 1	ssp.	1
TBLIDENTIFICATIONQUALIFIER.IDENTQUALIFIERNAME: GENUS AND SPECIES UNCERTAIN, FAMILY IDENTIFIED; TBLIDENTIFICATIONQUALIFIER.IDENTQUALIFIERCODE: GENUS ? SPECIES ?, FAMILY KNOWN;	genus in question	1
TBLIDENTIFICATIONQUALIFIER.IDENTQUALIFIERNAME: GENUS AND SPECIES UNKNOWN, FAMILY IDENTIFIED; TBLIDENTIFICATIONQUALIFIER.IDENTQUALIFIERCODE: GENUS BLANK AND SPECIES BLANK OR "SP.", FAMILY KNOWN;	genus in question	1
TBLIDENTIFICATIONQUALIFIER.IDENTQUALIFIERNAME: GENUS IDENTIFIED, SPECIES UNCERTAIN; TBLIDENTIFICATIONQUALIFIER.IDENTQUALIFIERCODE: GENUS SPECIES ? OR ("SPECIES 1/A OR SPECIES 2/B") OR "AFFIN";	sp.	1
TBLIDENTIFICATIONQUALIFIER.IDENTQUALIFIERNAME: GENUS IDENTIFIED, SPECIES UNKNOWN; TBLIDENTIFICATIONQUALIFIER.IDENTQUALIFIERCODE: GENUS "SP.";	sp.	1
TBLIDENTIFICATIONQUALIFIER.IDENTQUALIFIERNAME: GENUS UNCERTAIN, SPECIES UNKNOWN, FAMILY IDENTIFIED; TBLIDENTIFICATIONQUALIFIER.IDENTQUALIFIERCODE: GENUS ? "SP." BUT FAMILY KNOWN;	genus in question	1
TBLIDENTIFICATIONQUALIFIER.IDENTQUALIFIERNAME: GENUS, SPECIES AND FAMILY UNCERTAIN; TBLIDENTIFICATIONQUALIFIER.IDENTQUALIFIERCODE: GENUS ? SPECIES ? FAMILY ?;	family in question	1
TBLIDENTIFICATIONQUALIFIER.IDENTQUALIFIERNAME: SOME UNCERTAINTY AS TO IDENTIFICATION; TBLIDENTIFICATIONQUALIFIER.IDENTQUALIFIERCODE: COMMON NAME ? OR "IDENTITY UNCERTAIN" IN NOTES;	id in question	1
TBLIDENTIFICATIONQUALIFIER.IDENTQUALIFIERNAME: SUBSPECIES UNCERTAIN; TBLIDENTIFICATIONQUALIFIER.IDENTQUALIFIERCODE: GENUS SPECIES SUBSPECIES ?;	ssp.	1
TBLIDENTIFICATIONQUALIFIER.IDENTQUALIFIERNAME: UNIDENTIFIED; TBLIDENTIFICATIONQUALIFIER.IDENTQUALIFIERCODE: GENUS AND SPECIES AND FAMILY VACANT OR BLANK;		1
TENT SP	species in question	1
TENUE SP. NOV.	sp. nov.	1
TRIBE: MICROTINI		1
TRIMERORHACHIS ALSO		1
UINTASORICINAE		1
UNIDENTATA PARV		1
UNIDENTATA PRAS		1
UNIDENTATA SEBE		1
UNIDENTIFIED		1
UNIDENTIFIED GEN. ET SP. 1	gen. indet.	1
UNIDENTIFIED GEN. ET SP. 2	gen. indet.	1
V. LARGE SP.	sp.	1
VENTRITE SP. 1	sp.	1
VENUSTA X SP.	venusta X sp.	1
VERY LARGE SP.	sp.	1
VESPERTILIONOIDEA CF FM	cf.	1
VIVAX X SP.	vivax X sp.	1
WAITE & LONGMAN, 1920		1
WEBSTERI SP.NOV.	sp. nov.	1
WHITE SP.	sp.	1
WIDE, MULTIPLICATE SP.	sp.	1
WILLII GEN & SP		1
WOOD-MASONI N.	sp. nov.	1
WORN		1
WORN, NOT ID-ABLE (WEIL 2004)		1
X "HYBRID"	x hybrid	1
X AMERICANA	x americana	1
X CAERULESCENS	x caerulescens	1
X CAFER	x cafer	1
X GENUS CHANGED FROM AMPHISPIZA ACCORDING TO CLEMENTS 6.7		1
X GEOLTHLYPIS	x geolthlypis	1
X HARLANI	x harlani	1
X HYBRID	x hybrid	1
X LUPUS	x lupus	1
X LUTEUS	x luteus	1
X MACROVRA	x macrovra	1
X OREGANUS	x oreganus	1
X PUNCTULATA	x punctulata	1
X TOLMIEI	x tolmiei	1
X VIRGINIANUS	x virginianus	1
